行く	iku	go
見る	miru	see, look at
多い	ooi	a lot of, many
家	ie	home, household
これ	kore	this, this one
それ	sore	that, that one
私	watashi	I
仕事	shigoto	work, job
いつ	itsu	when
する	suru	do, make
出る	deru	go out, leave
使う	tsukau	use, make use of
所	tokoro	place
作る	tsukuru	make, create
思う	omou	think
持つ	motsu	have, possess
買う	kau	buy
時間	jikan	time, hour
知る	shiru	know
同じ	onaji	same, identical
今	ima	now
新しい	atarashii	new
なる	naru	become
まだ	mada	(not) yet, still
あと	ato	after
聞く	kiku	hear, ask
言う	iu	say, tell
少ない	sukunai	few, little
高い	takai	high, tall
子供	kodomo	child
そう	sou	so, that way
もう	mou	already, yet
学生	gakusei	student
熱い	atsui	hot (to touch)
どうぞ	douzo	please
午後	gogo	afternoon, p.m.
長い	nagai	long
本	hon	book, volume
今年	kotoshi	this year (colloquial)
よく	yoku	often, well
彼女	kanojo	she, one’s girlfriend
どう	dou	how, what
言葉	kotoba	word, language
顔	kao	face
終わる	owaru	finish, end
一つ	hitotsu	one (thing)
あげる	ageru	give, offer (colloquial)
こう	kou	like this, such
学校	gakkou	school
くれる	kureru	be given
始める	hajimeru	start (something)
起きる	okiru	get up, get out of bed
春	haru	spring
午前	gozen	morning, a.m.
別	betsu	another, different
どこ	doko	where
部屋	heya	room
若い	wakai	young
車	kuruma	car, automobile
置く	oku	put, place
住む	sumu	live, reside
働く	hataraku	work
難しい	muzukashii	difficult
先生	sensei	teacher
立つ	tatsu	stand, rise
呼ぶ	yobu	call, name
大学	daigaku	university, college
安い	yasui	cheap, inexpensive
もっと	motto	more
帰る	kaeru	go back home
分かる	wakaru	understand
広い	hiroi	wide, big
数	suu	number
近い	chikai	near, close
そこ	soko	there
走る	hashiru	run
入れる	ireru	put in
教える	oshieru	teach, tell
歩く	aruku	walk, go on foot
会う	au	meet
書く	kaku	write
頭	atama	head
売る	uru	sell
大好き	daisuki	like (something) a lot
体	karada	body, physique
直ぐ	sugu	at once, soon
飛ぶ	tobu	fly
とても	totemo	very (colloquial)
誰	dare	who
好き	suki	favorite, liked
読む	yomu	read
次	tsugi	next
あなた	anata	you
飲む	nomu	drink
古い	furui	old
質問	shitsumon	question
今日	kyou	today (colloquial)
友達	tomodachi	friend, companion (colloquial)
早い	hayai	early
どれ	dore	what, which
美しい	utsukushii	beautiful
いつも	itsumo	always (colloquial)
足	ashi	leg, foot
起こす	okosu	wake (someone) up
見せる	miseru	show
娘	musume	daughter, girl
楽しむ	tanoshimu	enjoy
色	iro	color
みんな	minna	everybody (colloquial)
取る	toru	take, get
勉強	benkyou	study
できる	dekiru	can do, be good at
短い	mijikai	short, brief
落ちる	ochiru	fall, come down
息子	musuko	son
白い	shiroi	white, blank
飛行機	hikouki	airplane
病気	byouki	illness
冬	fuyu	winter
年	toshi	year, age
重い	omoi	heavy
胸	mune	chest, breast
払う	harau	pay (money, respect, attention, etc.)
軽い	karui	light (of weight)
見つける	mitsukeru	find
忘れる	wasureru	forget, leave behind
酒	sake	alcohol, rice wine
どちら	dochira	which (polite)
姉	ane	(one’s own) older sister
覚える	oboeru	memorize, learn
狭い	semai	narrow, small
赤い	akai	red
着る	kiru	wear, put on
笑う	warau	laugh, smile
一番	ichiban	most, best
授業	jugyou	class session, lecture
週	shuu	week
漢字	kanji	Chinese character
自転車	jitensha	bicycle
電車	densha	train
探す	sagasu	search for, look for
紙	kami	paper
歌う	utau	sing
遅い	osoi	slow, late
首	kubi	neck
速い	hayai	fast
一緒に	issho ni	together, at the same time
今月	kongetsu	this month
遊ぶ	asobu	play
遠い	tooi	far, distant
弱い	yowai	weak
耳	mimi	ear
座る	suwaru	sit, sit down
右	migi	right
浴びる	abiru	take (a shower)
肩	kata	shoulder
寝る	neru	lie down and sleep, go to sleep
消す	kesu	switch off, turn off
元気	genki	healthy, energetic
全部	zenbu	all, whole
去年	kyonen	last year (colloquial)
引く	hiku	draw, pull
図書館	toshokan	library
上げる	ageru	raise, lift
緑	midori	green
腕	ude	arm
ドア	doa	door (loan word)
女の子	onna no ko	little girl
男の子	otoko no ko	boy
私たち	watashitachi	we (colloquial)
近く	chikaku	near, close to
やる	yaru	do, give
かなり	kanari	fairly, rather
国	kuni	country
起こる	okoru	happen
秋	aki	autumn, fall
送る	okuru	send
死ぬ	shinu	die
気持ち	kimochi	feeling, sensation
乗る	noru	ride, take
いる	iru	be present, stay
木	ki	tree, wood
開ける	akeru	open, unlock (doors, windows, etc.)
閉める	shimeru	shut, close (doors, windows, etc.)
続く	tsuzuku	continue, follow
お医者さん	oishasan	doctor (polite)
円	en	Japanese yen
ここ	koko	here
待つ	matsu	wait, wait for
低い	hikui	low, short
もらう	morau	receive
食べる	taberu	eat
兄	ani	(one’s own) older brother
名前	namae	name
夫	otto	husband
一	ichi	one
結婚	kekkon	marriage
親	oya	parent
話す	hanasu	speak, talk
少し	sukoshi	a bit, a little while
閉じる	tojiru	shut, close (books, eyes, etc.)
時	toki	time, moment
米	kome	rice (grain)
切る	kiru	cut
楽しい	tanoshii	fun, enjoyable
服	fuku	clothes (colloquial)
後ろ	ushiro	back, behind
嬉しい	ureshii	happy, glad
腰	koshi	waist, lower back
日曜日	nichiyoubi	Sunday
昼	hiru	daytime, midday
お母さん	okaasan	mother (colloquial)
大学生	daigakusei	university student
終わり	owari	end, conclusion
背	se	height, stature
手伝う	tetsudau	help, assist
鼻	hana	nose
起きる	okiru	occur, happen, wake up, get up
載せる	noseru	place, put on
悲しい	kanashii	sad
しゃべる	shaberu	chat, talk
近く	chikaku	in the near future, before long
甘い	amai	sweet
テーブル	te-buru	table
食べ物	tabemono	food (colloquial)
始まる	hajimaru	begin
ゲーム	ge-mu	game
十	juu	ten
天気	tenki	weather
暑い	atsui	hot (of weather)
太い	futoi	thick, fat
晩	ban	evening, night (from sunset to bedtime)
土曜日	doyoubi	Saturday
痛い	itai	sore, painful
お父さん	otousan	father, dad (colloquial)
多分	tabun	probably, perhaps
時計	tokei	clock, watch
泊まる	tomaru	stay overnight
どうして	doushite	how come
掛ける	kakeru	hang, put on
曲がる	magaru	make a turn, turn
お腹	onaka	stomach, belly
ミーティング	mi-tingu	meeting
嫌い	kirai	dislike (habitual)
金曜日	kinyoubi	Friday
要る	iru	need, require
無い	nai	to not be
風邪	kaze	cold (illness)
黄色い	kiiroi	yellow
優しい	yasashii	gentle, kind
晴れる	hareru	be sunny, clear up
汚い	kitanai	dirty
茶色	chairo	brown
空く	suku	be empty, become less crowded
上る	noboru	go up, climb
ご飯	gohan	meal, cooked rice
日	nichi	counter for days
髪の毛	kaminoke	hair, each single hair
つける	tsukeru	switch on, turn on
月曜日	getsuyoubi	Monday
入る	hairu	enter
カタカナ	katakana	katakana
今週	konshuu	this week
開く	hiraku	open (books, eyes, etc.)
水	mizu	water
あれ	are	that (over there)
二	ni	two
締める	shimeru	tighten, fasten
まずい	mazui	bad (taste), distasteful
平仮名	hiragana	hiragana
曇る	kumoru	become cloudy
触る	sawaru	touch, feel
駄目	dame	no good
飲み物	nomimono	beverage, drink
木曜日	mokuyoubi	Thursday
曜日	youbi	day of the week
そば	soba	side, vicinity
こっち	kocchi	here, this way (casual)
火曜日	kayoubi	Tuesday
渇く	kawaku	be thirsty
三	san	three
水曜日	suiyoubi	Wednesday
二つ	futatsu	two (things)
今晩	konban	this evening, tonight
千	sen	thousand
六日	muika	six days, sixth of the month
お姉さん	onesan	older sister
直る	naoru	be repaired, get fixed
ちょっと	chotto	just a moment, just a little
四	yon	four (Japanese origin)
これから	korekara	from now on, after this
考える	kangaeru	think, consider
戻る	modoru	return to a point of departure
変える	kaeru	change (something), alter
朝	asa	morning
歯	ha	tooth
頑張る	ganbaru	work hard, do one’s best
携帯電話	keitaidenwa	cellular phone
雨	ame	rain
金	kane	money (colloquial)
易しい	yasashii	easy, simple (colloquial)
お兄さん	oniisan	older brother
大きい	ooki	big
小さい	chiisai	small
辛い	karai	spicy, hot
八	hachi	eight
あそこ	asoko	over there
来る	kuru	come
前	mae	front, before
五日	itsuka	five days, fifth of the month
いっぱい	ippai	full
酸っぱい	suppai	sour
違う	chigau	differ, be wrong
細い	hosoi	thin, slender
三つ	mittsu	three (things)
八日	youka	eight days, eighth of the month
高校生	koukousei	high school student
上手	jouzu	good, skilled
強い	tsuyoi	strong
七	nana	seven (Japanese origin)
二十日	hatsuka	20 days, 20th of the month
左	hidari	left
二日	futsuka	two days, second of the month
四つ	yottsu	four (things)
暖かい	atatakai	warm
ある	aru	exist, there is
いい	ii	good (informal/spoken form)
上	ue	up, above
駅	eki	train station
美味しい	oishii	tasty
昨日	kinou	yesterday (colloquial)
綺麗	kirei	pretty, clean
五	go	five
九つ	kokonotsu	nine (things)
お願い	onegai	favor
答える	kotaeru	give an answer
先	saki	ahead, first
寒い	samui	cold (temperature of the air)
四	shi	four (Chinese origin)
三日	mikka	three days, third of the month
下	shita	under, below
大丈夫	daijoubu	all right, OK
大人	otona	adult
出す	dasu	take out
父	chichi	(speaker’s) father
母	haha	(speaker’s) mother
月	tsuki	moon
妹	imouto	younger sister
冷たい	tsumetai	cold (to touch)
弟	otouto	younger brother
手	te	hand
十日	tooka	ten days, tenth of the month
口	kuchi	mouth
夏	natsu	summer
七つ	nanatsu	seven (things)
時々	tokidoki	sometimes
何	nani	what
人	hito	person
一人	hitori	one person
一日	tsuitachi	first of the month
九日	kokonoka	nine days, ninth of the month
方	hou	direction, side
他	hoka	other (Japanese origin)
僕	boku	I, me (usually used by young males)
欲しい	hoshii	want, desire (of the speaker)
万	man	ten thousand
見える	mieru	be visible, can see
道	michi	street, way
五つ	itsutsu	five (things)
目	me	eye
八つ	yattsu	eight (things)
止める	tomeru	stop (a car…). 止める (yameru) give up
四日	yokka	four days, fourth of the month
夜	yoru	night (from sunset to sunrise)
来年	rainen	next year
六	roku	six
悪い	warui	bad
お手洗い	otearai	toilet, bathroom
ご主人	goshujin	(someone else’s) husband
本当に	hontouni	really, truly
自分	jibun	self, oneself
ため	tame	sake, purpose
見つかる	mitsukaru	be found, be caught
休む	yasumu	take a rest, take a break
ゆっくり	yukkuri	slowly
六つ	muttsu	six (things)
花	hana	flower
動く	ugoku	move
線	sen	line
七日	nanoka	seven days, seventh of the month
以外	igai	except for
男	otoko	man, male
彼	kare	he, one’s boyfriend
女	onna	woman
妻	tsuma	woman
百	hyaku	hundred
辺	atari	vicinity
店	mise	shop, store
閉まる	shimaru	be shut, be closed
問題	mondai	problem, question
必要	hitsuyou	need, necessary
もつ	motsu	last long, be durable
開く	hiraku	open
昨年	sakunen	last year (formal, often used in writing)
治る	naoru	be cured, get well
ドル	doru	dollar
システム	shisutemu	system (loan word)
以上	ijou	more than, not less than
最近	saikin	recent, latest
世界	sekai	world
コンピューター	konpyu-ta-	computer
やる	yaru	give (to an inferior)
意味	imi	meaning, sense
増える	fueru	increase, accrue
選ぶ	erabu	choose, elect
生活	seikatsu	life, living
進める	susumeru	go ahead, proceed
続ける	tsuzukeru	continue, keep up
ほとんど	hotondo	almost, hardly
会社	kaisha	company, corporation
家	ie	house, dwelling
多く	ooku	much, largely
話	hanashi	talk, story
上がる	agaru	go up, rise (physical movement)
もう	mou	another, again
集める	atsumeru	collect, gather
声	koe	voice, sound
初めて	hajimete	for the first time
変わる	kawaru	change, turn into
まず	mazu	first of all, to begin with
社会	shakai	society
プログラム	puroguramu	program booklet
力	chikara	strength, power
今回	konkai	this time
予定	yotei	schedule, plan
まま	mama	as is, still (in the current state)
テレビ	terebi	television
減る	heru	decrease, diminish
消える	kieru	be extinguished, disappear
家族	kazoku	family, household
比べる	kuraberu	compare, contrast
生まれる	umareru	be born, come into existence
ただ	tada	free
これら	korera	these
調べる	shiraberu	investigate, check
事故	jiko	accident, trouble
電話	denwa	telephone, phone call
外国	gaikoku	foreign country
銀行	ginkou	bank
十分	juubun	enough, plentiful
あまり	amari	(not) much
写真	shashin	photograph
繰り返す	kurikaesu	repeat
種類	shurui	kind, type
意見	iken	opinion
新聞	shinbun	newspaper
文章	bunshou	sentence, writing
目立つ	medatsu	stand out, be conspicuous
相手	aite	opponent, the other party
病院	byouin	hospital
厚い	atsui	thick, bulky
忙しい	isogashii	busy, occupied
薄い	usui	thin, weak
川	kawa	river, stream
暗い	kurai	dark, gloomy
クラス	kurasu	class (in school)
黒い	kuroi	black, dark
バス	basu	bus
青い	aoi	blue
買い物	kaimono	shopping, purchase
薬	kusuri	drug, medicine
砂糖	satou	sugar
休み	yasumi	holiday, break
郵便局	yuubinkyoku	post office
住所	juusho	address
こちら	kochira	here, this way (polite)
財布	saifu	purse, wallet
パスポート	pasupo-to	passport
椅子	isu	chair
可愛い	kawaii	cute, sweet
お祖父さん	ojiisan	grandfather (colloquial)
切手	kitte	postage stamp
涼しい	suzushii	cool (of temperature)
いくつ	ikutsu	how many, how old
メニュー	menyu-	menu
電気	denki	electricity, electric light
勝つ	katsu	win
負ける	makeru	lose
建てる	tateru	build, erect
日記	nikki	diary
売り切れ	urikire	sell out
お巡りさん	omawarisan	police officer (colloquial)
目覚まし時計	mezamashitokei	alarm clock
レシート	reshi-to	receipt (loan word)
ティッシュ	tisshu	tissue
歯ブラシ	haburashi	toothbrush
下りる	oriru	go down, come down
洗う	arau	wash
パート	pa-to	part-time
氏名	shimei	full name
今夜	konya	tonight, this evening
夜中	yonaka	midnight
来週	raishuu	next week
誰か	dareka	someone
何	nan	what. それはなんですか. What is that?
今朝	kesa	this morning
寿司	sushi	sushi
履く	haku	put on (shoes), wear (pants, skirt)
おじさん	ojisan	uncle
おばさん	obasan	aunt
お祖母さん	obaasan	grandmother (colloquial)
いとこ	itoko	cousin
辞書	jisho	dictionary (category)
朝ご飯	asagohan	breakfast
白	shiro	white
どっち	docchi	which (casual)
そっち	socchi	there (casual)
明日	ashita	tomorrow (colloquial)
明後日	myougonichi/asatte	day after tomorrow (colloquial)
一昨日	ototoi	the day before yesterday (colloquial)
庭	niwa	garden, yard
左側	hidarigawa	left side
右側	migigawa	right side
指	yubi	finger, toe
眼鏡	megane	glasses
鞄	kaban	bag, handbag
あっち	acchi	other side, over there (casual)
大人しい	otonashii	gentle, quiet
下手	heta	not good at
厳しい	kibishii	strict, severe
一人で	hitoride	by oneself, alone
答え	kotae	answer, solution
この頃	konogoro	these days, recently
残念	zannen	regretful, disappointing
仕舞う	shimau	put away, put in
心配	shinpai	anxiety, worry
外	soto	outside, open air
大切	taisetsu	important, valuable
ちょうど	choudo	just, exactly
助ける	tasukeru	help, save
勤める	tsutomeru	serve, hold a job
連れていく	tsureteiku	take along, bring along (a person)
丈夫	joubu	healthy, sturdy
賑やか	nigiyaka	lively, exciting
眠い	nemui	sleepy
山	yama	mountain
橋	hashi	bridge
止まる	tomaru	come to a stop, cease
降る	furu	fall, come down (rain, snow, etc.)
本当	hontou	reality, genuine
町	machi	town, city
お菓子	okashi	sweets, snacks
緩い	yurui	slack, loose
良い	yoi	good (formal/written form)
ようこそ	youkoso	welcome (greeting)
お土産	omiyage	souvenir (polite)
両親	ryoushin	parents
ウェーター	we-ta-	waiter
ウェートレス	we-toresu	waitress
絶対に	zettaini	absolutely, definitely
ごちそう	gochisou	feast, treat
フォーク	fo-ku	fork
スプーン	supu-n	spoon
瓶	bin	bottle
つく	tsuku	be on, be switched on
醤油	shouyu	soy sauce
茶碗	chawan	rice bowl
決める	kimeru	decide, agree upon
感じる	kanjiru	feel, sense
生きる	ikiru	live (one’s life)
動かす	ugokasu	move (something)
壊れる	kowareru	break, break down
復習	fukushuu	review
眉	mayu	eyebrow
客	kyaku	visitor, customer
机	tsukue	desk
風呂	furo	bath
湯	yu	hot water
ぬるい	nurui	tepid, lukewarm
風邪薬	kazegusuri	cold medicine
靴下	kutsushita	socks
タバコ	tabako	tobacco, cigarette
アイスコーヒー	aisuko-hi-	iced coffee
天ぷら	tempura	Japanese deep-fried food
肉	niku	flesh, meat
昨夜	sakuya	last night, last evening (colloquial)
流行る	hayaru	be in fashion, be popular
連れて来る	tsuretekuru	bring (a person)
方	kata	person (polite form)
零	rei	zero
雲	kumo	cloud
空	sora	sky
人気	ninki	popularity
兄さん	niisan	(one’s own) older brother (polite)
姉さん	neesan	(one’s own) older sister (polite)
平成	heisei	Heisei era
毎月	maitsuki	every month
半日	hannichi	half a day
半月	hantsuki	half a month
なるほど	naruhodo	I see, really
つまり	tsumari	in short, that is to say
そのまま	sonomama	as it is, just like that
はっきり	hakkiri	clearly
大変	taihen	awful, hard
簡単	kantan	simple, easy
似ている	niteiru	look like, resemble
驚く	odoroku	be surprised, be startled
嫌	iya/ kira-i	dislike (situational)
喧嘩	kenka	fight, argument
遅れる	okureru	be late
にんじん	ninjin	carrot
ジャガイモ	jagaimo	potato
ナス	nasu	eggplant
やかん	yakan	kettle
話し合う	hanashiau	discuss, talk over
残す	nokosu	leave, leave undone
ごちそうする	gochisousuru	treat, host (a meal)
合う	au	fit, match
当たる	ataru	(go straight and) hit, strike
集まる	atsumaru	gather, be collected
場所	basho	place, space
海	umi	sea, ocean
少年	shounen	boy (between 7 and 18 years old)
孫	mago	grandchild
生徒	seito	pupil, student
高校	koukou	high school (for short)
年上	toshiue	older, senior
卒業	sotsugyou	graduation
運動	undou	movement, exercise
選手	senshu	athlete, (sports) player
映画	eiga	movie
英語	eigo	English
手紙	tegami	letter
動物	doubutsu	animal
音	oto	sound, noise
海外	kaigai	overseas, abroad
外国人	gaikokujin	foreigner
帰国	kikoku	return to one’s country
彼ら	karera	they
機械	kikai	machine
基本	kihon	basics
今度	kondo	this time, next time
最後	saigo	last
最初	saisho	first, outset
準備	junbi	preparation, arrangement
進む	susumu	advance, move forward
直接	chokusetsu	directly
特に	tokuni	specially, particularly
届く	todoku	reach, be received
なぜ	naze	why
並ぶ	narabu	line up, be parallel
運ぶ	hakobu	carry, transport
直す	naosu	repair, fix
反対	hantai	oppose, object
場合	baai	situation, case
詳しい	kuwashii	detailed
いたずら	itazura	mischief, prank
お祝い	oiwai	celebrate
くし	kushi	comb
こぼれる	koboreru	spill, overflow
伝える	tsutaeru	convey, transmit
膝	hiza	knee
肘	hiji	elbow
枕	makura	pillow
建物	tatemono	building, structure
道路	douro	road
四つ角	yotsukado	intersection
曲がり角	magarikado	corner (to turn)
警察	keisatsu	police
空気	kuuki	air, atmosphere
スポーツ	supo-tsu	sport
チャンス	chansu	chance
クリーニング	kuri-ningu	dry cleaning
サービス	sa-bisu	service, on the house
グループ	guru-pu	group
自宅	jitaku	one’s house, one’s home
家庭	katei	home, family
期間	kikan	term, period
年度	nendo	year, school year
経験	keiken	experience, knowledge
安全	anzen	safety, security
危険	kiken	danger, dangerous
注意	chuui	attention, care
成功	seikou	success
努力	doryoku	endeavor, effort
説明	setsumei	explanation, description
地震	jishin	earthquake
手術	shujutsu	surgical operation
火傷	yakedo	burn
課題	kadai	task, assignment
子	ko	young child, kid
確認	kakunin	confirmation
実際	jissai	reality, actual state
国際	kokusai	international (used in compound nouns)
会議	kaigi	conference, meeting
提案	teian	proposition, proposal
事務所	jimusho	office, one’s place of business
教授	kyouju	professor
世紀	seiki	century
あちこち	achikochi	all over, here and there
そちら	sochira	there, that way (polite)
あちら	achira	over there, that way (polite)
もし	moshi	if, in case of
うるさい	urusai	noisy, annoying
固い	katai	stiff, tight
深い	fukai	deep, profound
面白い	omoshiroi	interesting, amusing
全く	mattaku	entirely, truly
半分	hanbun	half
普通	futsuu	normal, regular
分	bun	amount, share
文化	bunka	culture
毎日	mainichi	every day
気を付ける	kiwotsukeru	be careful about, pay attention to
守る	mamoru	protect, observe
もちろん	mochiron	of course
やはり	yahari	as expected
いくら	ikura	how much (money)
よろしく	yoroshiku	one’s regards
どなた	donata	who (polite)
許す	yurusu	permit, forgive
分ける	wakeru	divide, share
自然	shizen	nature
アパート	apa-to	apartment, flat
ホテル	hoteru	hotel
パソコン	pasokon	personal computer
うまい	umai	good at
明るい	akarui	bright, cheerful
急ぐ	isogu	hurry, do quickly
歌	uta	song
中学校	chuugakkou	junior high school
テスト	tesuto	test
ポスト	posuto	postbox, mailbox
ハンカチ	hankachi	handkerchief
髪	kami	hair, hairstyle
帽子	boushi	hat, cap
被る	kaburu	wear, put on (on one’s head)
ブラウス	burausu	blouse
週末	shuumatsu	weekend
先週	senshuu	last week
再来週	saraishuu	the week after next
いつか	itsuka	some time, some day
宿題	shukudai	homework
鍵	kagi	key, lock
傘	kasa	umbrella, parasol
乗り換える	norikaeru	change, transfer
向かう	mukau	face, head toward
本屋	honya	bookstore (colloquial)
お茶	ocha	tea (polite)
改札口	kaisatsuguchi	ticket gate
晴れ	hare	fine weather, clear sky
バス停	basutei	bus stop
曇り	kumori	cloudy weather
塩	shio	salt
たくさん	takusan	a lot, in large quantity
大嫌い	daikirai	hate
中	naka	inside, middle
二階	nikai	second floor, upstairs
無くす	nakusu	lose, get rid of
まあまあ	maamaa	OK, not bad
黄色	kiiro	yellow color
ランチ	ranchi	lunch (loan word)
魚	sakana	fish
味	aji	taste, flavor
りんご	ringo	apple
みかん	mikan	tangerine
皿	sara	plate, counter (for plates or helpings)
コーヒー	ko-hi-	coffee
コップ	koppu	cup, glass
二人	futari	two persons
止む	yamu	stop, cease
九	kyuu	nine
昼間	hiruma	daytime, during the day
いつ頃	itsugoro	about when, about what time
字	ji	(individual) character, letter
七	nana	seven (Chinese origin)
お釣り	otsuri	change (of money)
名字	myouji	surname, family name
おじ	oji	(one’s own) uncle
おば	oba	(one’s own) aunt
祖父	sofu	grandfather (formal)
祖母	sobo	grandmother (formal)
大事	daiji	importance
見方	mikata	view, perspective
鳥	tori	bird, poultry
犬	inu	dog
返事	henji	reply, answer, response
また	mata	again, also, or
年間	nenkan	period of one year
青	ao	blue, green
赤	aka	red color
信号	shingou	signal, traffic light
円	en	circle
非常に	hijouni	very, extremely
複雑	fukuzatsu	complicated, intricate
平和	heiwa	peace, harmony
回る	mawaru	turn round, go around
若者	wakamono	young person, youth
雪	yuki	snow, snowfall
うまい	umai	sweet, delicious
思い出す	omoidasu	recollect, recall
聞こえる	kikoeru	hear, be heard
借りる	kariru	borrow
返す	kaesu	return, repay
受け取る	uketoru	receive, get
捨てる	suteru	discard, abandon
一緒	issho	together, same (colloquial)
遊び	asobi	play, amusement
移す	utsusu	move, transfer
大きさ	ookisa	size, dimension
考え	kangae	thought, idea
空港	kuukou	airport (for public transportation)
出発	shuppatsu	departure, starting
地図	chizu	map, atlas
運転	unten	drive
降りる	oriru	get off, land
ガス	gasu	gas (loan word)
必ず	kanarazu	without exception, always
カメラ	kamera	camera
通う	kayou	go to and from, frequent a place
急に	kyuuni	suddenly, unexpectedly
サラリーマン	sarari-man	office worker, company employee
給料	kyuuryou	salary, pay
曲	kyoku	piece of music
切れる	kireru	cut well, be sharp
正しい	tadashii	correct, righteous
苦しい	kurushii	painful, agonizing
細かい	komakai	minute, fine
静か	shizuka	quiet, tranquil
健康	kenkou	health
ゴルフ	gorufu	golf
コース	ko-su	course, route
頼む	tanomu	order, ask for
困る	komaru	be in trouble, not know what to do
ずっと	zutto	all the time, all through
例えば	tatoeba	for example
つもり	tsumori	intention, purpose
しばらく	shibaraku	a little while, a while
紹介	shoukai	introduction
小学校	shougakkou	elementary school
公園	kouen	park, public garden
中学	chuugaku	junior high
成績	seiseki	results, grade
教科書	kyoukasho	textbook, schoolbook
席	seki	seat, one’s place
教室	kyoushitsu	classroom, class
教師	kyoushi	teacher, instructor
試験	shiken	exam
合格	goukaku	pass an examination
数学	suugaku	mathematics
数字	suuji	numeric characters
音楽	ongaku	music
食事	shokuji	meal
壁	kabe	wall, partition
信じる	shinjiru	believe, trust
育てる	sodateru	bring up, raise
倒れる	taoreru	fall over
落とす	otosu	drop
代わる	kawaru	substitute, be substituted for
タクシー	takushi-	taxi
確か	tashika	for sure, for certain
立てる	tateru	stand, set up
中学生	chuugakusei	junior high school student
売れる	ureru	sell, be in demand
着く	tsuku	arrive at, reach
決まる	kimaru	be decided
飾る	kazaru	decorate
殺す	korosu	kill
下げる	sageru	lower, turn down
贈る	okuru	offer, give
訪ねる	tazuneru	visit, go to see
打つ	utsu	hit, strike
相談	soudan	consultation, advice
玄関	genkan	entrance, door
兄弟	kyoudai	sibling
長男	chounan	eldest son
高さ	takasa	height
用	you	things to do
時代	jidai	age, era
位置	ichi	position, location
季節	kisetsu	season
穴	ana	hole
裏	ura	the back, the reverse side
島	shima	island (Japanese origin)
海岸	kaigan	seashore, coast
ガラス	garasu	glass (material)
自然	shizen	natural
風	kaze	wind
科学	kagaku	science
太陽	taiyou	sun
台風	taifuu	typhoon
北	kita	north
馬	uma	horse
牛肉	gyuuniku	beef
雑誌	zasshi	magazine, journal
小説	shousetsu	novel
大使館	taishikan	embassy
故障	koshou	malfunction, breakdown
温度	ondo	temperature
何か	nanika	something, some
向こう	mukou	over there, on the other side
真ん中	mannaka	center, middle (casual)
遠く	tooku	far away, at a distance
横	yoko	side, width across
つまらない	tsumaranai	boring, dull
素晴らしい	subarashii	excellent, wonderful
毎年	maitoshi/ mainen	every year (colloquial)
来月	raigetsu	next month
日時	nichiji	date and time
夕方	yuugata	early evening, at dusk
通る	tooru	pass, go through
自動車	jidousha	automobile
慣れる	nareru	grow accustomed to, get used to
撮る	toru	take (a photograph), film
やっと	yatto	at last, finally
どんどん	dondon	knock, bang
並べる	naraberu	line up, arrange
逃げる	nigeru	escape, run away
渡す	watasu	hand over, give
値段	nedan	price
両方	ryouhou	both
約束	yakusoku	promise, vow
一部	ichibu	part
ラジオ	rajio	radio
入院	nyuuin	be hospitalized
ニュース	nyu-su	news
旅行	ryokou	travel, trip
用意	youi	preparation
伸びる	nobiru	stretch, grow
パーティー	pa-ti-	party
ビール	bi-ru	beer
早く	hayaku	early, soon
番組	bangumi	program
ビデオ	bideo	video
増やす	fuyasu	increase
振る	furu	wave, shake
迎える	mukaeru	welcome, receive (a visitor)
無理	muri	unreasonable, impossible
珍しい	mezurashii	rare, scarce
有名	yuumei	famous
喜ぶ	yorokobu	be happy, be delighted
留学	ryuugaku	study abroad
料理	ryouri	cooking
野菜	yasai	vegetable
分かれる	wakareru	be divided, split off
特別	tokubetsu	special
理由	riyuu	reason, excuse
自由	jiyuu	freedom
方向	houkou	direction, course
残る	nokoru	remain, be left over
ビル	biru	building
まとめる	matomeru	gather together, put in order
流れる	nagareru	flow, run
セーター	se-ta-	sweater
シャツ	shatsu	shirt
洗濯	sentaku	laundry, washing
間違える	machigaeru	make a mistake, fail at
アイスクリーム	aisukuri-mu	ice cream
乾く	kawaku	become dry
冷める	sameru	cool off
色々	iroiro	a variety of
持って行く	motteiku	take, bring
着替える	kigaeru	change clothes
石鹸	sekken	soap
野球	yakyuu	baseball
昼食	chyuushoku	lunch
朝食	choushoku	breakfast
眠る	nemuru	sleep, lie idle
初め	hajime	beginning
火	hi	fire, flame
西	nishi	west, western
東	higashi	east, eastern
南	minami	south
夕食	yuushoku	supper, dinner
なかなか	nakanaka	rather, pretty
励ます	hagemasu	encourage, cheer up
涙	namida	tear
夢	yume	dream
職場	shokuba	place of work, office
隣	tonari	next to, next door
マンション	manshon	apartment, residential building
エレベーター	erebe-ta-	elevator
窓	mado	window
押す	osu	push, press down
入学	nyuugaku	enter a school, matriculate
戸	to	door, sliding door
通り	toori	street, road
亡くなる	nakunaru	die, pass away
夫婦	fuufu	husband and wife, married couple
女性	josei	woman, female (formal)
森	mori	forest
トラック	torakku	truck
レコード	reko-do	record
熱	netsu	heat, fever
ページ	pe-ji	page
踊る	odoru	dance
長さ	nagasa	length
厚さ	atsusa	thickness
秘密	himitsu	secret, privacy
凄い	sugoi	great, incredible
親切	shinsetsu	kind, kindhearted
絶対	zettai	absolutely, never
先月	sengetsu	last month
一昨年	ototoshi	the year before last (colloquial)
冬休み	fuyuyasumi	winter vacation
夏休み	natsuyasumi	summer vacation
休日	kyuujitsu	day off, holiday
正月	shougatsu	New Year, January
思い出	omoide	memory
たまに	tamani	occasionally, by chance
おかしい	okashii	strange, peculiar
浅い	asai	shallow, superficial
君	kimi	you (referring to fellows or subordinates)
奥さん	okusan	(somone else’s) wife, married woman
赤ちゃん	akachan	baby (colloquial)
小学生	shougakusei	elementary school student
貸す	kasu	lend, lease
数える	kazoeru	count
生む	umu	give birth, produce
育つ	sodatsu	be brought up, grow
是非	zehi	by all means, please
黒	kuro	black
おもちゃ	omocha	toy, plaything
靴	kutsu	shoes
連絡	renraku	contact, communication
伝言	dengon	message
預ける	azukeru	deposit, leave (something) with (someone)
下がる	sagaru	go down, drop
泳ぐ	oyogu	swim
アルバイト	arubaito	part-time job
コート	ko-to	coat, jacket (loan word)
趣味	shumi	hobby, interest
散歩	sanpo	walk, stroll
幸せ	shiawase	happiness, satisfied (colloquial)
安心	anshin	peace of mind, relief
大勢	oozei	large numbers, a lot of (people)
医者	isha	doctor (colloquial, plain)
運転手	untenshu	driver
新幹線	shinkansen	bullet train
往復	oufuku	round trip
コピー	kopi-	copy, photocopy
奥	oku	inner part, the back
重さ	omosa	weight
親しい	shitashii	intimate, familiar
修理	shuuri	repair, mending
カード	ka-do	card
挨拶	aisatsu	greet, greeting
階段	kaidan	steps, flight of stairs
配る	kubaru	hand out, distribute
断る	kotowaru	refuse, turn down
グラム	guramu	gram
濃い	koi	strong, concentrated
壊す	kowasu	break (something), destroy
桜	sakura	cherry tree, cherry blossom
仕方	shikata	way, method
絵	e	picture, painting
気温	kion	air temperature
品物	shinamono	article, goods
吸う	suu	inhale, suck
案内	annai	guide, guidance
スキー	suki-	ski, skiing
金持ち	kanemochi	wealthy person
尋ねる	tazuneru	inquire, ask
叩く	tataku	tap, hit
帰り	kaeri	return, going home
卵	tamago	egg
氷	koori	ice
留学生	ryuugakusei	student studying abroad
ソフト	sofuto	software, program
歯医者	haisha	dentist
蹴る	keru	kick
敷く	shiku	lay, spread
ひととき	hitotoki	some moments, a while
交通事故	koutsuujiko	traffic accident
遭う	au	meet, encounter, get caught in
招待	shoutai	invitation
咲く	saku	bloom, blossom
二十歳	hatachi	20 years old
銀	gin	silver
内側	uchigawa	inside, interior
池	ike	pond
石	ishi	stone, small rock
愛	ai	love
課	ka	section, division
大学院	daigakuin	graduate school
台所	daidokoro	kitchen
カラー	kara-	color (loan word)
すり	suri	pickpocket
キャンプ	kyanpu	camping, camp
オートバイ	o-tobai	motorbike, motorcycle
建つ	tatsu	be built, be erected
刺す	sasu	sting, stab
言い方	iikata	way of speaking, expression
沈む	shizumu	sink
組み立てる	kumitateru	set up, put together
恐ろしい	osoroshii	terrible, awful
外人	gaijin	foreigner, alien
牛	ushi	cattle, cow
食堂	shokudou	cafeteria, restaurant
毎年	mainen	every year (formal)
毎週	maishuu	every week
何度	nando	how many times, how many degrees
なかなか	nakanaka	not easily, not readily
さっき	sakki	earlier, only a moment ago
久しぶり	hisashiburi	after a long time
便利	benri	convenience
迷惑	meiwaku	trouble, annoyance
そんなに	sonnani	so much
びっくりする	bikkurisuru	be surprised, be startled (casual)
足りる	tariru	suffice, be enough
疲れる	tsukareru	get tired, become fatigued
ひどい	hidoi	cruel, awful
全然	zenzen	(not ) at all
猫	neko	cat
デパート	depa-to	department store (loan word)
トイレ	toire	toilet
地下鉄	chikatetsu	subway
駐車場	chuushajou	parking area, parking lot
ぶつかる	butsukaru	hit, bump into
運賃	unchin	(passenger) fare
通学	tsuugaku	commuting to school
見送る	miokuru	see (someone) off
泣く	naku	cry, weep
レストラン	resutoran	restaurant
メモ	memo	memo, note
予約	yoyaku	reservation, appointment
番号	bangou	assigned number
注文	chuumon	order
パン	pan	bread
ワイン	wain	wine
材料	zairyou	material, ingredient
豚肉	butaniku	pork
焼く	yaku	bake, grill
匂い	nioi	(pleasant) smell, odor
付ける	tsukeru	attach, apply, put
痩せる	yaseru	lose weight, become thin
届ける	todokeru	deliver
間に合う	maniau	be in time, suffice
向く	muku	turn, face
強さ	tsuyosa	strength
得意	tokui	one’s specialty, be good at
塗る	nuru	spread on, paint
投げる	nageru	throw
習う	narau	learn, take lessons
注目	chuumoku	attention, notice
未来	mirai	future
箱	hako	box, case
右手	migite	right hand
左手	hidarite	left hand
プール	pu-ru	pool
ピアノ	piano	piano
光る	hikaru	shine, emit light, sparkle
踏む	fumu	step on, tread on
別々	betsubetsu	separately
ボール	bo-ru	ball
握る	nigiru	grasp, grip, hold
真っ赤	makka	deep red
拾う	hirou	pick up
回す	mawasu	turn, rotate (something)
ノート	no-to	notebook (loan word)
辞める	yameru	resign, leave (one’s job), quit
揺れる	yureru	shake, sway
立派	rippa	fine, elegant
練習	renshuu	practice, training
割る	waru	divide, split
部分	bubun	part, section
拭く	fuku	wipe, dry
招く	maneku	invite
急	kyuu	urgent, steep
汚れる	yogoreru	become dirty
渡る	wataru	cross, go across
途中	tochuu	on the way, half way
インタビュー	intabyu-	interview (loan word)
盗む	nusumu	steal, rob
普段	fudan	usual, ordinary
旅館	ryokan	Japanese inn
博物館	hakubutsukan	museum
ホーム	ho-mu	platform (for short)
引っ越す	hikkosu	move, relocate
荷物	nimotsu	baggage, load
家賃	yachin	rent
計画	keikaku	plan
廊下	rouka	hallway, corridor
天井	tenjou	ceiling
ベッド	beddo	bed
ソファー	sofa-	sofa, couch
屋根	yane	roof
祭り	matsuri	festival
離婚	rikon	divorce
葉	ha	leaf
ボート	bo-to	light boat, small craft
燃える	moeru	burn, catch on fire
巻く	maku	roll up, wrap
プラスチック	purasuchikku	plastic
訪れる	otozureru	go and visit (place)
破る	yaburu	tear, breach
関係	kankei	relation, relationship
録音	rokuon	(sound) recording
不幸	fukou	unhappiness, misfortune
外国語	gaikokugo	language
着物	kimono	traditional Japanese clothes
牛乳	gyuunyuu	milk
救急車	kyuukyuusha	ambulance
果物	kudamono	fruit
間違い	machigai	mistake, error
映画館	eigakan	movie theater
怖い	kowai	scary, be afraid
鏡	kagami	mirror
草	kusa	grass, weed
敬語	keigo	polite speech
欠席	kesseki	absence
スイッチ	suicchi	switch
掃除	souji	cleaning
畳	tatami	straw mat
速さ	hayasa	speed
林	hayashi	woods, forest
プレゼント	purezento	present (loan word)
弁当	bentou	boxed lunch
いつでも	itsudemo	at all times, any time
寂しい	sabishii	lonely, desolate, sad
少しも	sukoshimo	(not) in the least
尊敬	sonkei	respect, esteem
テニス	tenisu	tennis
広さ	hirosa	area, extent
読み	yomi	reading
我慢	gaman	patience, endurance
国籍	kokuseki	nationality, citizenship
恥ずかしい	hazukashii	embarrassed, ashamed
ボタン	botan	button
洋服	youfuku	(western-style) clothes
油	abura	oil
おかしい	okashii	funny, comical
余る	amaru	remain, be in excess
コート	ko-to	sports court
正直	shoujiki	honest, upright
ドラマ	dorama	drama
ビザ	biza	visa
水道	suidou	tap water
店員	tenin	clerk, salesperson
電池	denchi	battery
ポケット	poketto	pocket
握手	akushu	handshake
そろそろ	sorosoro	soon, it’s about time
ぶどう	budou	grapes
迷う	mayou	get lost
見物	kenbutsu	sightseeing, visit
知らせる	shiraseru	let know, inform
神社	jinja	Shinto shrine
注射	chuusha	injection, shot
めったに	mettani	rarely, seldom
作文	sakubun	composition, essay
鳴る	naru	sound, ring
真面目	majime	serious and sincere
申し込む	moushikomu	apply, sign up
冷蔵庫	reizouko	refrigerator
気に入る	kiniiru	like, be pleased with
クリスマス	kurisumasu	Christmas
ネクタイ	nekutai	tie, necktie
誕生日	tanjoubi	birthday
独身	dokushin	single, unmarried
苦い	nigai	bitter
バイオリン	baiorin	violin
バッグ	baggu	bag
今まで	imamade	until now
切符	kippu	ticket
ゴム	gomu	elastic, rubber
少々	shoushou	a little, a bit
随分	zuibun	extremely, considerably
引っ張る	hipparu	pull, drag
焼ける	yakeru	burn, cook
鉛筆	enpitsu	pencil
会話	kaiwa	conversation
ギター	gita-	guitar
茶	cha	tea
暑さ	atsusa	heat (of weather)
胃	i	stomach
禁煙	kinen	non-smoking
丸い	marui	round
写る	utsuru	be photographed
喫茶店	kissaten	coffee shop, café
やっぱり	yappari	just as I thought, after all
週刊誌	shuukanshi	weekly magazine
棚	tana	shelf, rack
震える	furueru	tremble, shake
磨く	migaku	polish, grind
カーテン	ka-ten	curtain
火事	kaji	fire, blaze
ナイフ	naifu	knife
皆さん	minasan	everybody, everyone (polite)
受ける	ukeru	receive, take, undergo
付く	tsuku	stick to, cling to
私	watakushi	I (formal)
結構	kekkou	quite
悪口	warukuchi	slander, abuse
広まる	hiromaru	spread, get around
内緒	naisho	secrecy, privacy
つぶる	tsuburu	close (eyes)
用件	youken	matter, things to be done
ロマンチック	romanchikku	romantic
貯金	chokin	savings, deposit
バイク	baiku	motorcycle
預かる	azukaru	take care of, keep
オレンジ	orenji	orange
噛む	kamu	bite, chew
きつい	kitsui	tight, tough
越える	koeru	go over, go across
小包	kodutsumi	parcel, package
新年	shinnen	new year
配達	haitatsu	delivery
動物園	doubutsuen	zoo
封筒	fuutou	envelope
危ない	abunai	dangerous
テキスト	tekisuto	text, textbook
ビニール	bini-ru	plastic, vinyl
アルバム	arubamu	album
水泳	suiei	swimming
混む	komu	be crowded, be congested
スカート	suka-to	skirt
取れる	toreru	come off, be removed
ペン	pen	pen
物	mono	thing, object
郵便	yuubin	mail service, postal mail
割れる	wareru	crack, split
駅員	ekiin	station attendant
おしゃべり	oshaberi	talkative, chatty
緑色	midoriiro	green color
毎朝	maiasa	every morning
曲げる	mageru	bend (something)
きっと	kitto	surely, certainly
理科	rika	science (school subject)
下着	shitagi	underwear
太る	futoru	grow fat, gain weight
冷房	reibou	air conditioning (cooling)
別れる	wakareru	separate, part
空く	aku	become available or vacant
出掛ける	dekakeru	go out, leave home
毎晩	maiban	every evening
指輪	yubiwa	ring
腐る	kusaru	rot, go bad
貧乏	binbou	poverty, destitution
おしゃれ	oshare	trendy, fashionable
休憩	kyuukei	break
舌	shita	tongue
ジュース	ju-su	juice
ゼロ	zero	zero, none (loan word)
朝刊	choukan	morning edition paper
丁寧	teinei	polite, careful
苦手	nigate	not good at, be bad at
日	hi	(specific) day, sun, daytime
引っ越し	hikkoshi	moving (house)
歩道	hodou	sidewalk, pavement
折れる	oreru	break, snap
見送り	miokuri	send-off
夕刊	yuukan	evening edition paper
この間	konoaida	the other day, not so long ago
冷える	hieru	cool down, get chilled
ピンク	pinku	pink
グラス	gurasu	glass
毛	ke	hair, down
黒板	kokuban	blackboard
積もる	tsumoru	pile up
半年	hantoshi	half a year
現在	genzai	the present, present time
利用	riyou	utilization, usage
方法	houhou	method, procedure
中心	chuushin	center (of a circle, etc.), core
明らか	akiraka	clear, obvious
社長	shachou	president (of a company)
ほぼ	hobo	almost, nearly
商品	shouhin	goods, commodities
大型	oogata	large, large scale
限る	kagiru	be limited to
記録	kiroku	record, documentation
具体的	gutaiteki	concrete, specific
効果	kouka	effect, result
公開	koukai	opening (to the public)
作品	sakuhin	work of art, creation
迫る	semaru	close in on, approach
大会	taikai	tournament, event
背景	haikei	background, backdrop
文字	moji	character, letter, writing
規則	kisoku	rule, regulation
近所	kinjo	neighborhood
グラフ	gurapu	chart, graph
首都	shuto	capital
減らす	herasu	reduce (something)
隠れる	kakureru	hide
美術館	bijutsukan	art museum
ばか	baka	foolish, stupid
暇	hima	free time, spare time
絵葉書	ehagaki	picture postcard
あんなに	annani	that much, such
行き	iki	going, bound for
通勤	tsuukin	commute
ちゃんと	chanto	correctly, properly
のんびり	nonbiri	take it easy
緊張	kinchou	tension, strain
気付く	kiduku	notice, realize
物語	monogatari	story, tale
出口	deguchi	exit
登る	noboru	climb, go up
真っ白	masshiro	pure-white
下ろす	orosu	bring down, take down
貸し出す	kashidasu	lend, lend out
サッカー	sakka-	soccer, football
暖房	danbou	heating
手袋	tebukuro	gloves
留守	rusu	not at home
嘘	uso	lie
遠慮	enryo	restraint, hold back
折る	oru	break (something), fold (something)
スープ	su-pu	soup
バナナ	banana	banana
可哀相	kawaisou	poor, pitiful
パトカー	patoka-	police car
ハンバーガー	hanba-ga-	hamburger
毛布	moufu	blanket
エスカレーター	esukare-ta-	escalator
お嬢さん	ojousan	young lady, daughter
手帳	techou	pocket notebook
タオル	taoru	towel
売店	baiten	booth, shop
パチンコ	pachiko	pachinko (Japanese pinball)
謝る	ayamaru	apologize
ケーキ	ke-ki	cake
天気予報	tenkiyohou	weather forecast
変	hen	strange, weird
一生懸命	isshoukenmei	hard-working, doing one’s best
間違う	machigau	make a mistake, be wrong
事務室	jimushitsu	office
スーツ	su-tsu	suit
チケット	chiketto	ticket (loan word)
チョコレート	chokore-to	chocolate
脱ぐ	nugu	take off (clothes)
年賀状	nenkajou	New Year’s card
乗り物	norimono	vehicle, transportation
布団	futon	Japanese-style padded mattress
役に立つ	yakunitatsu	be useful, be helpful
破れる	yabureru	tear, rip open
用事	youji	errand, business
写す	utsusu	copy, photograph
腕時計	udedokei	wrist watch
贈り物	okurimono	present, gift
チャンネル	channeru	channel
冷やす	hiyasu	chill (something), cool down
片付ける	katazukeru	put in order, clean up
乾杯	kanpai	toast, drink (in celebration)
停車	teisha	stop (of a train)
鳴く	naku	sing, cry (of animals)
ガソリンスタンド	gasorinsutando	gas station
片道	katamichi	one way (trip)
交番	kouban	police box
大分	daibu	greatly, fairly, highly
デート	de-to	date, romantic meeting
梅雨	tsuyu	rainy season
真っ直ぐ	massugu	straight
レモン	remon	lemon
上着	uwagi	outerwear, coat, jacket
偉い	erai	great, eminent
書き方	kakikata	how to write, way of writing
炊く	taku	cook (rice)
チーズ	chi-zu	cheese
ドライブ	doraibu	drive (loan word)
踏切	fumikiri	railroad crossing
ラケット	raketto	racket
受付	uketsuke	receptionist, information office
怒る	okoru	get angry, scold
化粧	keshou	makeup
都合	tsugou	convenience, availability
ひげ	hige	beard, moustache
本棚	hondana	bookshelf, bookcase
真っ暗	makkura	pitch-dark
沸く	waku	boil, get loud (crowd applause etc.)
売り切れる	urikireru	sell out, go out of stock
押し入れ	oshiire	sliding-door closet
革	kawa	leather
ぐっすり	gussuri	soundly
紅茶	koucha	black tea
邪魔	jama	disturbance, blocking
ソース	so-su	sauce
足す	tasu	add (things of the same kind)
トマト	tomato	tomato
バター	bata-	butter
発車	hassha	departure (of a vehicle)
バレーボール	bare-ho-ru	volleyball
おかず	okazu	dishes to go with the rice
カレンダー	karenda-	calendar
とにかく	tonikaku	in any case, anyway
楽しみ	tanoshimi	enjoyment, something looked forward to
おしゃべり	oshaberi	chatter, idle talk
読書	dokusho	reading books
寒気	samuke	chill
夕焼け	yuuyake	sunset glow
傷める	itameru	damage, hurt
くすぐったい	kusuguttai	ticklish
泥棒	dorobou	thief, burglar
襖	fusuma	paper sliding door
美人	bijin	beautiful woman
タイプライター	taipuraita-	typewriter
再来年	sarainen	the year after next
冗談	joudan	joke
近付く	chikaduku	approach, come close
電話帳	denwachou	telephone book
ベル	beru	bell
干す（ほす）	hosu	hang (something) out to dry
金額	kingaku	amount of money, sum
蚊	ka	mosquito
悲しむ	kanashimu	feel sad, lament
クーラー	ku-ra-	air conditioner (cooling)
失礼	shitsurei	rudeness, to excuse oneself
洗濯機	sentakuki	washing machine, washer
豆腐	toufu	tofu
昼寝	hirune	nap
不便	fuben	inconvenient
ミルク	miruku	milk (loan word)
向こう側	mukougawa	other side
億	oku	hundred million
お礼	orei	thanks, gratitude
着せる	kiseru	dress (someone)
サラダ	sarada	salad
代える	kaeru	substitute for
四角	shikaku	square
急行	kyukou	express train
交差点	kousaten	crossing, intersection
覚める	sameru	awake, wake up (naturally)
昼休み	hiruyasumi	lunch break
ベルト	beruto	belt
真っ黒	makkuro	black, jet-black
皆様	minasama	everyone, ladies and gentlemen
ラーメン	ra-men	ramen (Chinese noodles)
ライター	raita-	lighter
ワイシャツ	waishatsu	business shirt, dress shirt
転ぶ	korobu	fall down, fall over
シャワー	shawa-	shower
扇風機	senpuuki	electric fan
遅刻	chikoku	tardiness, lateness
釣る	tsuru	fish, catch
うどん	udon	Japanese wheat noodles
仮名	kana	kana
記念日	kinenbi	memorial day, anniversary
下り	kudari	downhill, going down
掲示板	keijiban	notice board, bulletin board
凍る	kooru	freeze
ごみ	gomi	trash
スーパーマーケット	su-pa-ma-ketto	supermarket
ぶらぶら	burabura	wander, walk around
アナウンサー	anaunsa-	announcer
自炊	jisui	cooking (for oneself)
止める	tomeru	stop (something/someone)
年下	toshishita	younger, junior
治す	naosu	cure (something)
箸	hashi	chopsticks
花見	hanami	flower viewing
引き出し	hikidashi	drawer
訳	yaku	translation
いかが	ikaga	how
交通費	koutsuuhi	traveling expense, transportation fee
ステレオ	sutereo	stereo
再会	saikai	meeting again, reunion
滑る	suberu	slide, slip
早口	hayakuchi	speaking fast
裏返す	uragaesu	turn over, turn inside out
角	kado	corner, edge
きらきら	kirakira	sparkling, glittering
三角	sankaku	figure, area etc.
激しい	hageshii	violent, intense
経営	keiei	management, operation
拡大	kakudai	magnification, enlargement
姿勢	shisei	posture, attitude
周辺	shuuhen	area, region
他	ta	other (Chinese origin)
達する	tassuru	attain, reach
当時	touji	at that time
当然	touzen	natural, as a matter of course
能力	nouryoku	capability, performance ability of machine, etc.
判断	handan	judgment, decision
過ぎる	sugiru	pass by, go past
正確	seikaku	accurate, precise
戦争	sensou	war between countries
放送	housou	broadcasting
習慣	shuukan	custom, habit
フィルム	fuirumu	film
受け付ける	uketsukeru	receive, accept
ダンス	dansu	dance, dancing (loan word)
こんなに	konnani	this much, such
吹く	fuku	blow, play (a wind instrument)
まあ	Maa	well (interjection)
メール	me-ru	e-mail
インターネット	inta-netto	Internet
出身	shusshin	come from, origin
職業	shokugyou	occupation, job
スター	suta-	star
くだらない	kudaranai	worthless, trifling
名簿	Meibo	name list
通常	Tsuujou	common, usually, typically
家内	kanai	one’s wife
消防署	Shoubousho	fire station
再び	Futatabi	again, a second time
大統領	Daitouryou	president (of a country)
入場券	Nyuujouken	entrance ticket
ネックレス	nekkuresu	necklace
パジャマ	pajama	pajamas
ボールペン	Borupen	ballpoint pen
かゆい	kayui	itchy
覚ます	samasu	awaken, wake up
すいか	Suika	watermelon
そば	Soba	buckwheat noodles
特急	tokkyuu	super-express
のり	Nori	glue, starch
大抵	たいてい	generally, mostly
バスケットボール	basukettobo-ru	basketball
酔っ払う	yopparau	get drunk
どきどき	Dokidoki	feel excited, feel nervous
欲しがる	hoshigaru	want, desire (of the third person)
早起き	Hayaoki	getting up early
味噌汁	misoshiru	miso soup
読み方	yomikata	how to read, way of reading
入り口	iriguchi	entrance
降ろす	orosu	unload, set down
掛かる	kakaru	hang
サンドイッチ	sandoicchi	sandwich
四角い	Shikakui	square-shaped
突き当たる	tsukiataru	run into, come to the end (of a road)
乾かす	kawakasu	dry (something)
定期券	Teikiken	commuter pass
にこにこ	nikoniko	smilingly, keep smiling
下る	kudaru	go down, go away from
ウール	wu-ru	wool
コーラ	ko-ra	cola, coke
トイレットペーパー	Toirettopepa	toilet paper
乗り換え	norikae	transfer, change (trains)
灰皿	haizara	ashtray
ハム	hamu	ham
床	yuka	floor
ローマ字	Ro-maji	Roman alphabet
いちご	ichigo	strawberry
カレーライス	kareaisu	curry rice
キャッシュカード	Kyasshukado	cash card
停留所	teiryuujo	(bus) stop
床屋	tokoya	barber, barbershop
歯磨き	hamigaki	brushing one’s teeth
夕飯	ゆうはん	evening meal, dinner
酔っ払い	yopparai	drunkard, drunk
例	Rei	example
お辞儀	Ojigi	bow
横断歩道	Oudan hodou	pedestrian crossing, crosswalk
ぐらぐら	guragura	shaky, unstable
航空便	Koukuubin	airmail, airfreight
ジャム	Jamu	jam
スリッパ	Surippa	slippers
畳む	tatamu	fold, shut, close
トランプ	toranpu	playing cards
日陰	hikage	shade of the sun
文房具	bunbougu	stationery, writing materials
免許証	menkyoshou	license
訳す	yakusu	translate
よろしい	yoroshii	all right
両替	ryougae	money exchange
片付く	kataduku	be put in order, be finished
カップ	kappu	cup
消しゴム	keshigomi	eraser
スケート	suketo	skate, skates
鍋	nabe	pan
寝坊	nebou	oversleeping
鋏	hasami	scissors
真っ青	massao	deep-blue, pale
汚す	yogosu	make (something) dirty
忘れ物	wasuremono	something left behind, lost item
掛け算	kakezan	multiplication
臭い	kusai	stinky
突き当たり	tsukiatari	end of a street
マフラー	mafura-	scarf, muffler
桃	momo	peach
アクセサリー	akusesari-	accessories, jewelry
あくび	akubi	yawn
あめ	ame	candy
上り	nobori	going up, ascent
なるべく	narubeku	as…as possible, if possible
じっと	jitto	without moving, still
食器	shokki	tableware
延ばす	nobasu	extend, postpone
薬局	yakkyoku	drugstore, pharmacy
雄	osu	male (animal)
雌	mesu	female (animal)
和風	wafuu	Japanese inspired
いびき	ibiki	snoring
ピクニック	pikunikku	picnic
地域	chiiki	region, area
勘違い	kanchigai	misunderstanding, wrong idea or assumption
重要	juuyou	important, essential
主人	shujin	one’s husband, master
お宅	otaku	(someone else’s) home
ハイキング	haikingu	hiking
畑	hatake	field, farm
ボーイフレンド	boifurendo	boyfriend
イヤリング	iyaringu	earrings
ガールフレンド	ga-rufurendo	girlfriend
柔らか	yawaraka	soft, gentle
納豆	natto	fermented soybeans
別に	Betsuni	particularly, not really
どうしても	Doushitemo	by any means, really
父親	chichioya	father
誘う	sasou	invite, ask out
母親	hahaoya	mother, female parent
昼前	hirumae	in the morning, before noon
ふらふら	furafura	be dizzy, lightheaded
こぼす	kobosu	spill (something)
持ってくる	mottekuru	bring
振り向く	Furimuku	turn around, look back
洗面所	Senmenjou	washroom, bathroom
外側	sotogawa	exterior, outside
段々	dandan	gradually, little by little
包む	tsutsumu	wrap, pack
無くなる	nakunaru	get lost, go missing
豚	buta	pig
褒める	homeru	praise, compliment
沸かす	wakasu	boil (water)
暖める	atatameru	warm (something) up
換える	kaeru	exchange, convert
安っぽい	yasuppoi	cheap-looking, tacky
ぎらぎら	giragira	glaring, blinding
何とか	nantoka	somehow, please
いよいよ	iyoiyo	finally, any moment
がらがら	garagara	not crowded
缶詰	kantzume	canned food
怪我	kega	injury
寒さ	samusa	coldness, cold
祝日	shukujitsu	holiday
すき焼き	Sukiyaki	sukiyaki
葉書	hagaki	postcard
掃く	haku	sweep
何しろ	nanishiro	anyhow, as you may know
どんどん	dondon	quickly, rapidly
ぺこぺこ	pekopeko	hungry, starving
ぺらぺら	perapera	fluently
レインコート	reinkoto	raincoat
アイス	aisu	ice cream (for short)
塩辛い	shiokarai	salty
セロテープ	serote-pu	scotch tape
大幅	oohaba	drastically, substantially
教育	Kyouiku	education
工事	Kouji	construction, repairing
担当	tantou	person in charge (of official duties)
法律	Houritsu	law
丸	maru	circle, round
発表	happyo	announcement
研究	kenkyuu	research, study
一方	ippou	one way, the other party
国内	kokunai	domestic, internal
全体	zentai	whole, total
後	nochi	after, afterward
人間	ningen	human being
刺身	sashimi	sliced raw fish or meat
ばら	Bara	rose
ねずみ	nezumi	rat, mouse
以下	ika	below
昔	mukashi	old times, the old days
訳	wake	reason, sense
違い	chigai	difference, mistake
しっかり	shikkari	mature, responsible
将来	Shourai	future, in the future
不思議	fushigi	mystery, wonder
決して	kesshite	never, by no means
失敗	shippai	failure, mistake
番	ban	one’s turn, watch
出会う	deau	meet, encounter
悩む	nayamu	be troubled, suffer
汗	ase	sweat
すっかり	sukkari	all, completely
代わり	kawari	substitution, alternative
一言	hitokoto	single word, brief speech
豊か	yutaka	rich, ample
接続	setsuzoku	connection, joining
抱える	kakaeru	hold in one’s arms
エンジン	enjin	engine
少女	shoujo	young girl
無駄	muda	pointless, waste
自動	jidou	automatic operation
先輩	senpai	senior, superior
眺める	nagameru	look out, gaze
書類	Shorui	documents, papers
年月	nengetsu	years, period of time
燃やす	moyasu	burn (something)
線路	senro	railway track, line
水着	mizugi	bathing suit, swimsuit
可愛らしい	kawairashii	lovely, charming
仲良し	nakayoshi	good friend
梅干し	umeboshi	pickled plum
ドレス	doresu	formal dress
尽くす	tsukusu	make utmost efforts, devote to
地球	chikyuu	the earth
不親切	fushinsetsu	unkind, inconsiderate
からから	karakara	very thirsty, very dry
本箱	honbako	bookcase
横書き	yokogaki	horizontal writing
そば屋	sobaya	buckwheat noodle shop
加工	kakou	processing
実験	jikken	experiment
愛する	aisuru	love, care for
あんまり	anmari	(not) that much, (not) so much
いきなり	ikinari	all of a sudden, suddenly
表	omote	front, outside
汚れ	yogore	dirt, blot
間	aida	interval, space between things
紫	murasaki	purple
灰色	haiiro	ash color, gray
血	chi	blood (colloquial)
顎	ago	jaw, chin
始めに	hajimeni	in the beginning, first
暖まる	atatameru	get warm
お世辞	oseji	compliment, flattery
袋	fukuro	bag, sack
長袖	nagasode	long sleeves
半袖	hansode	short sleeves
形	katachi	shape, form
景色	keshiki	natural scenery or landscape
ざあざあ	zaazaa	pouring
再来月	saraigetsu	the month after next
泊める	tomeru	let (someone) stay over
叱る	shikaru	scold, reprimand
騒ぐ	sawagu	make a noise, make a racket
車道	Shadou	road, roadway (for cars)
掃除機	Soujiki	vacuum cleaner
剃る	soru	shave
貼る	haru	stick, paste, put
台	dai	stand, table
主に	omoni	mostly, predominantly
倒す	taosu	knock down, overthrow
星	hoshi	star, planet
長女	choujo	eldest daughter
爪	tsume	nail, claw
缶	kan	can, tin
とんとん	tonton	tapping, patting
袖	sode	sleeve
濡れる	nureru	get wet
パーセント	pa-sento	percent
上がる	agaru	go up, increase (in quality or quantity)
拍手	hakushu	applause, clapping
弾く	hiku	play (instruments)
ひも	himo	laces, string
昼過ぎ	hirusugi	early afternoon
船	fune	ship, vessel
まく	maku	scatter, sprinkle
姪	mei	niece
個人	kojin	individual person
歌手	kashu	singer
社員	Shain	staff member, employee
不動産屋	fudousanya	real estate agent
最大	saidai	biggest, largest
動き	ugoki	movement, motion
事件	jiken	affair, incident
過去	kako	the past
協力	kyouryoku	cooperation, collaboration
時期	jiki	time, season
経つ	tatsu	pass, elapse
雷	kaminari	thunder, lightning
責任	sekinin	responsibility
願う	negau	wish, desire
発見	hakken	discovery, revelation
気	ki	spirit, temperament
美容院	byouin	hair salon
状況	joukyou	state of affairs, conditions
目的	mokuteki	objective, purpose
企業	kigyou	corporation, business
釣り	tsuri	fishing
漫画	manga	comics, cartoon
温泉	onsen	hot spring
トレーニング	tore-ningu	training, workout
噂	uwasa	gossip, rumor
本物	honmono	real, truly worthy (things, people)
アイデア	aidea	idea
地下	chika	underground
マーケット	ma-ketto	market
スケジュール	sukeju-ru	schedule (loan word)
出張	shucchou	business trip
コック	kokku	cook, chef
正午	shougo	noon
ブラシ	burashi	brush
書き取る	kakitoru	write down, note down
歓迎	kangei	welcome, greet
開発	kaihatsu	development
郵便屋さん	yuubinyasan	mail carrier
会長	kaichou	president, chairperson
金	kin	gold
灰	hai	ashes
骨	hone	bone
風呂屋	furoya	bathhouse, public bath
細か	komaka	small, fine, detailed
行き	yuki	going, bound for (traditional reading)
人々	hitobito	people
寺	tera	temple
鶏	niwatori	rooster, hen
港	minato	port, harbor
移る	utsuru	move, shift
異なる	kotonaru	differ
提供	teikyou	offer, provide
市民	shimin	citizens
患者	kanja	patient
元旦	gantan	morning of the January 1st, New Year’s Day
柔らかい	yawarakai	soft, gentle
似合う	niau	suit, match well
確かめる	tashikameru	check, confirm
背中	senaka	(one’s) back
肌	hada	human skin, surface
順番	junban	order, turn
まとも	matomo	sane, reasonable
ぴったり	pittari	exactly right, perfect
思わず	omowazu	unintentionally, unconsciously
より	yori	even more ~, even less ~
もったいない	mottainai	wasteful, a shame
情報	jouhou	information
諦める	akirameru	abandon, give up
懐かしい	natsukashii	fondly-remembered, long-forgotten
怪しい	ayashii	suspicious, dubious
示す	shimesu	show, indicate
たっぷり	tappuri	fully, amply
早速	sassoku	immediately, right away
偶然	guuzen	by chance, coincidence
続き	tsuduki	continuation, sequel
合計	goukei	sum, total
傷	kizu	wound, scar
面倒	mendou	troublesome, difficult
具合	guai	condition, health
中止	chuushi	suspension, cancellation
手続き	tetsuduki	procedure, proceeding
結果	kekka	result, outcome
建設	kensetsu	construction (of a building, road, bridge, etc.)
販売	hanbai	sale, selling
機能	kinou	function, feature
頃	koro	time, the time when ~
日中	Nicchuu	during the day
今後	Kongo	in the future, from now on
影響	eikyou	influence, effect
分野	bunya	field, area
関する	kansuru	relate to, regarding
状態	joutai	state, condition
価格	kakaku	price, value
姿	sugata	figure, appearance
期待	kitai	expectation, anticipation
除く	nozoku	remove, exclude
一般	ippan	general, common
表現	hyougen	expression
完成	kansei	completion, finish making or building something
変化	henka	change, alteration
参加	sanka	participation
土地	tochi	land
検討	kentou	examination and consideration
開始	kaishi	beginning
備える	sonaete	provide for, prepare for
内容	naiyou	content
与える	ataeru	give (formal)
広がる	hirogaru	spread out, extend
事実	jijitsu	fact, truth
決定	kettei	decision
住宅	juutaku	housing, residence
代表	daihyou	representative
命令	meirei	command, order
立場	tachiba	standpoint, position
なお	Nao	still, in addition
計算	keisan	calculation
可能	kanou	possible, potential
報告	houkoku	report
都市	toshi	city, town
政治	seiji	politics
競争	kyousou	competition
原因	genin	cause, origin
活動	katsudou	activity
歴史	rekishi	history
表	hyou	table, list
サイト	saito	website
土産	miyage	souvenir (plain)
臭い	nioi	(bad) smell
現金	genkin	cash
虫	mushi	insect, bug
寄る	yoru	stop by, stop off
田舎	inaka	hometown, countryside
帰宅	kitaku	return home, come home
重大	juudai	important, serious
マイナス	mainasu	minus, below zero
稼ぐ	kasegu	earn, make money
左右	sayuu	right and left
痛み	itami	pain, ache
誤解	gokai	misunderstanding
文句	monku	complaint, grumble
欧米	oubei	Europe and America
面接	mensetsu	interview
サイン	sain	signature, autograph
年中	nenjuu	all year
機嫌	kigen	mood, health
居間	ima	living room
度々	tabitabi	often
例文	reibun	example sentence
怠ける	namakeru	be lazy, slack off
転勤	tenkin	change of job location, relocation
政府	seifu	government, administration
所有	shoyuu	ownership, own
いずれ	izure	sometime later, eventually
対する	taisuru	face, be in response to
教会	kyoukai	church
ご存知	gozonji	know (honorific)
雀	suzume	sparrow
適当	tekitou	proper, adequate
残り	nokori	rest, leftover
戻す	modosu	put (something) back
体重	taijuu	body weight
どうせ	douse	anyway
あれこれ	arekore	this and that, one thing or another
湖	mizuumi	lake
とうとう	toutou	finally, in the end
負け	make	defeat, loss
悔しい	kuyashii	frustrating, regrettable
姉妹	shimai	sisters
助かる	tasukaru	be helped, be rescued
手前	temae	in front
さっぱり	sappari	completely not
ついで	tsuide	on the way, to take the opportunity
すっきり	sukkiri	refreshed
とんでもない	tondemonai	unthinkable, outrageous
坂	saka	slope, hill
飛び込む	tobikomu	dive into, jump into
コメント	komento	comment
書き直す	kakinaosu	rewrite
看護婦	kangofu	female nurse
就職	shuushoku	finding a job, getting a job
糸	ito	thread, yarn
売り場	uriba	sales floor, department
校長	kouchou	principal, schoolmaster
見学	kengaku	field trip
進学	shingaku	advance to higher education
退院	taiin	discharge from hospital
テント	tento	tent
踊り	odori	dance, dancing
植える	ueru	plant, sow
幼稚園	youchien	kindergarten
エアメール	eameeru	airmail
四季	shiki	the four seasons
ナイロン	nairon	nylon
消防車	shoubousha	fire engine
ハンドバッグ	handobaggu	handbag
農業	nougyou	agriculture
アイロン	airon	iron (for clothes)
ラッシュアワー	rasshuawaa	rush hour
速達	sokutatsu	special delivery, express delivery
予習	yoshuu	preparation, previewing (a lesson)
書留	kakitome	registered mail
深さ	fukasa	depth, profundity
ウィスキー	wisukii	whisky
シャープペンシル	shaapupenshiru	mechanical pencil
取引	torihiki	transaction, deal
設ける	moukeru	set up, establish
一定	ittei	fixed, certain
記者	kisha	journalist, reporter
基準	kijun	standard, criterion
傾向	keikou	tendency, disposition
契約	keiyaku	contract, agreement
産業	sangyou	industry
事情	jijou	circumstances, conditions
実行	jikkou	practice, execution
組織	soshiki	organization, structure
逮捕	taiho	arrest, capture
程度	teido	degree, extent
同様	douyou	similar, the same as
要求	youkyuu	need, demand
貿易	boueki	(export and import) trade
輸出	yushutsu	export
商業	shougyou	commerce, trade
船便	funabin	surface mail, shipping service
選挙	senkyo	election
住民	juumin	resident
出席	shusseki	attendance, presence
発言	hatsugen	utterance, remark
伴う	tomonau	accompany, entail
採用	saiyou	employment, adoption
処理	shori	handling, processing
解決	kaiketsu	solution, settlement
全国	zenkoku	the whole country
作業	sagyou	work, operation
生産	seisan	production
管理	kanri	management, administration
増加	zouka	increase, rise
特徴	tokuchou	distinctive feature, characteristic
強調	kyouchou	emphasis, stress
制度	seido	system
株	kabu	stock, share
加える	kuwaeru	add (things of the same or different kinds)
強化	kyouka	strengthening
設計	sekkei	design, plan
段階	dankai	stage, phase
行う	okonau	do, carry out
経済	keizai	economy, economics
工場	koujou	factory, plant
技術	gijutsu	skill, technology
施設	shisetsu	facilities, institution
神	kami	God
人口	jinkou	population
党	tou	party, faction
輸入	yunyuu	import
煮る	niru	simmer, cook
コンサート	konsaato	concert
ガソリン	gasorin	gasoline
パンツ	pantsu	pants, trousers
そっくり	sokkuri	almost identical
名刺	meishi	business card, name card
いちいち	ichiichi	every time, about everything
しつこい	shitsukoi	persistent, pesky
喉	nodo	throat
身長	shinchou	height
何で	nande	why, what for
味噌	miso	soybean paste
気の毒	kinodoku	pitiful, poor
そっと	sotto	softly, gently
こっそり	kossori	secretly
うっかり	ukkari	carelessly, accidentally
わざと	wazato	on purpose
がっかり	gakkari	disappointed, disappointing
ぼんやり	bonyari	vacantly, absent-mindedly
酢	su	vinegar
羨ましい	urayamashii	envious, jealous
捕まえる	tsukamaeru	catch, arrest
ちっとも	chittomo	not at all
親指	oyayubi	thumb
通り過ぎる	toorisugiru	go past, pass
屋上	okujou	housetop, rooftop
蓋	futa	lid, cover
いつの間にか	itsunomanika	before noticing it, out of nowhere
象	zou	elephant
嫌がる	iyagaru	dislike, be unwilling
わがまま	wagamama	selfish
徹夜	tetsuya	staying up all night
まあまあ	maamaa	now now, well well
ふざける	fuzakeru	mess around, fool around
一度に	ichidoni	all at once, at a time
頷く	unazuku	nod
改札	kaisatsu	ticket gate
手伝い	tetsudai	help, assistance
とっくに	tokkuni	long ago, already
洗剤	senzai	detergent
手首	tekubi	wrist
日帰り	higaeri	a day trip
取り消す	torikesu	cancel
あきれる	akireru	be amazed at, be stunned by (something negative)
月末	getsumatsu	end of the month
咳	seki	cough
あいにく	ainiku	unfortunately, we are afraid that
近寄る	chikayoru	go near, approach
うろうろ	urouro	in a loafing-about manner, not really knowing what to do
重たい	omotai	heavy, serious
かじる	kajiru	nibble, bite
長引く	nagabiku	be prolonged, drag on
せっせと	sesseto	diligently, hard
横切る	yokogiru	cut across
取り替える	torikaeru	change, replace
からかう	karakau	make fun of, tease
好き嫌い	sukikirai	likes and dislikes, taste
蒸し暑い	mushiatsui	hot and humid
支度	shitaku	preparation, getting ready
薄暗い	usugurai	gloomy, dim
着替え	kigae	change of clothes
ワンピース	wanpiisu	one-piece dress
生年月日	seinengappi	year and date of birth
虫歯	mushiba	cavity
留守番	rusuban	looking after the house
張り切る	harikiru	go all out, be full of energy (to do something)
意地悪	ijiwaru	mean, ill-natured
生意気	namaiki	impudent, cocky
シーツ	shiitsu	bed sheet
フライパン	furaipan	frying pan
一人一人	hitorihitori	each and every person
話し掛ける	hanashikakeru	start a conversation, speak to (someone)
追い掛ける	oikakeru	chase, run after
小指	koyubi	little finger, little toe
ぴかぴか	pikapika	shiny, glittering
中指	nakayubi	middle finger, middle toe
まぶた	mabuta	eyelid
面倒臭い	mendoukusai	troublesome, tiresome
ゆでる	yuderu	boil
できるだけ	dekirudake	as (much) as possible
もしかしたら	moshikashitara	possibly, perhaps
いつまでも	itsumademo	forever
まぶしい	mabushii	dazzling, glaring
おやつ	oyatsu	snack, refreshment
空っぽ	karappo	empty
ぶつぶつ	butsubutsu	in a mutter, mumble
すっと	sutto	(feel) refreshed, satisfied
図々しい	zuuzuushii	impudent, cheeky
にっこり	nikkori	smiling brightly
けち	kechi	stingy, miser
追い付く	oitsuku	catch up with
くしゃみ	kushami	sneeze
冷ます	samasu	let cool
だらしない	darashinai	untidy, sloppy
甘やかす	amayakasu	be indulgent to, spoil
いらいら	iraira	irritated
薬指	kusuriyubi	ring finger
のろのろ	noronoro	slowly, sluggishly
ポイント	pointo	point
工業	kougyou	industry, the manufacturing industry
構造	kouzou	construction, structure
さすが	sasuga	just as expected, true to reputation
居眠り	inemuri	doze, catnap
散らかす	chirakasu	make a mess
濡らす	nurasu	get (something) wet
日にち	hinichi	date (fixed for something)
苛める	ijimeru	bully, abuse
足下	ashimoto	step, under foot
うさぎ	usagi	rabbit, hare
紺	kon	dark blue, navy blue
目茶苦茶	mechakucha	in a mess, chaotic
立ち入り禁止	tachiirikinshi	no trespassing
間もなく	mamonaku	soon, in a short time
通帳	tsuuchou	bankbook, passbook
しびれる	shibireru	go numb, fall asleep
ぎっしり	gisshiri	tightly, closely
うがい	ugai	gargling
思い付く	omoitsuku	think of, hit upon
宛名	atena	name of recipient, addressee
戸棚	todana	cupboard
焦げる	kogeru	be burned, be scorched
かく	kaku	scratch
威張る	ibaru	be arrogant, be boastful
人混み	hitogomi	crowd
ずらり	zurari	lining up neatly
思い切り	omoikiri	to one’s heart’s content, with all one’s might
青白い	aojiroi	pale
しゃがむ	shagamu	squat down
言葉遣い	kotobadukai	wording, language
通り掛かる	toorikakaru	happen to pass by
御無沙汰	gobusata	be out of touch
市場	shijou	market (industrial, financial, etc.)
データ	deeta	data
購入	kounyuu	purchase
ビジネス	bijinesu	business
俺	ore	I (masculine sense)
登録	touroku	registration
体験	taiken	personal experience
デザイン	dezain	design
負担	futan	burden, charge
詳細	shousai	details, particulars
アップ	appu	close-up
終了	shuuryou	end, termination
ファン	fan	fan, admirer
予想	yosou	expectation, forecast
企画	kikaku	planning, project
財政	zaisei	public finance, financial affairs
総合	sougou	integration, put together
ケース	keesu	case
メーカー	meekaa	maker, manufacturer
治療	chiryou	medical treatment
読者	dokusha	reader
職員	shokuin	staff, employee
世代	sedai	generation
視点	shiten	viewpoint, perspective
効率	kouritsu	efficiency, performance
資産	shisan	property, assets
取り組む	torikumu	work on, tackle
ルール	ruuru	rule
資格	shikaku	qualifications, competence
成果	seika	result
前提	zentei	assumption, premise
現地	genchi	local, on-site
内部	naibu	interior, inner parts
所得	shotoku	income, earnings
恋愛	renai	romance, relationship
支持	shiji	support
危機	kiki	crisis, danger
マスコミ	masukomi	mass media, media
証拠	shouko	proof, evidence
コーナー	koonaa	section (of a store etc.), corner
マーク	maaku	logo
減少	genshou	decrease, decline
緊急	kinkyuu	urgent, emergency
要望	youbou	demand, request
ストレス	sutoresu	stress
主催	shusai	sponsorship, host
ベスト	besuto	best
犠牲	gisei	sacrifice, loss
暴力	bouryoku	violence, force
赤字	akaji	deficit, in the red
個性	kosei	individuality, unique characteristics
作戦	sakusen	tactic, strategy
ショック	shokku	shock
アンケート	ankeeto	questionnaire
わざわざ	wazawaza	going out of one’s way to do something
本気	honki	serious, earnest
悩み	nayami	troubles, worries
上司	joushi	boss
説得	settoku	persuasion
ブーム	buumu	fad, boom
体力	tairyoku	physical strength, stamina
正常	seijou	normal
ヒント	hinto	hint, clue
地獄	jigoku	hell
後悔	koukai	regret
情熱	jounetsu	passion, enthusiasm
驚き	odoroki	surprise, amazement
ジャンプ	janpu	jump
アルコール	arukooru	alcohol, alcoholic beverage
いい加減	iikagen	irresponsible, careless
わくわく	wakuwaku	feel excited, be thrilled
言い訳	iiwake	excuse
ミュージック	myuujikku	music
青春	seishun	blossom of youth, adolescence
あっさり	assari	bluntly, easily
焦る	aseru	feel pressured, feel hurried
柔軟	juunan	pliable, flexible
タレント	tarento	celebrity, TV personality
どうにか	dounika	somehow
コンテスト	kontesuto	contest, competition
もてる	moteru	be popular (esp. with the opposite sex)
デザート	dezaato	dessert
クイズ	kuizu	quiz, quiz show
中毒	chuudoku	poisoning, addiction
ムード	muudo	mood
同情	doujou	sympathy, compassion
学歴	gakureki	educational background
好調	kouchou	good condition
アマチュア	amachua	amateur
炒める	itameru	stir-fry
カメラマン	kameraman	photographer
問い合わせる	toiawaseru	inquire, ask for (information)
しょっちゅう	shocchuu	frequently, repeatedly
ロープ	roopu	rope
ストライキ	sutoraiki	strike
パンク	panku	flat tire
コマーシャル	komaasharu	commercial, advertising
チェンジ	chenji	change, exchange
待ち合わせ	machiawase	meeting with someone, appointment
時差	jisa	time difference
義理	giri	sense of duty, obligation
さっと	satto	quickly
左利き	hidarikiki	left-handedness
サボる	saboru	slack of, ditch
だるい	darui	feel run-down, weary
ポット	potto	pot, thermos
レントゲン	rentogen	X-rays
心強い	kokoroduyoi	reassuring, heartening
無駄遣い	mudadukai	wasteful spending
バッジ	bajji	badge
眼科	ganka	ophthalmology, eye clinic
履歴書	rirekisho	resume, curriculum vitae
インフレーション	infureeshon	inflation
癌	gan	cancer
ぺこぺこ	pekopeko	bow, kowtow
嘘つき	usotsuki	liar
おごる	ogoru	treat, pay for (someone)
十字路	juujiro	crossroads
びっしょり	bisshori	drenched, soaked
だぶだぶ	dabudabu	baggy, too big
おだてる	odateru	flatter
かかと	kakato	heel
ほっと	hotto	feel relieved
傷付ける	kizutsukeru	hurt (someone), damage (something)
うつむく	utsumuku	look down, lower one’s eyes
前売り券	maeuriken	advance ticket
短期	tanki	short-term
舐める	nameru	lick
本日	honjitsu	today (formal)
業界	gyoukai	industry, business world
ネットワーク	nettowaaku	network
弁護士	bengoshi	lawyer, attorney
入力	nyuuryoku	input, entry
前回	zenkai	last time
画面	gamen	screen
後半	kouhan	latter half, second half
自信	jishin	confidence
素敵	suteki	lovely, nice
当たり前	atarimae	no wonder, natural
やり方	yarikata	way of doing
わずか	wazuka	meager, marginal
ついに	tsuini	at last, at length
次回	jikai	next time
スピード	supiido	speed
バイト	baito	part-time job
不可能	fukanou	impossible
アドバイス	adobaisu	advice
落ち着く	ochitsuku	calm down, settle in
せっかく	sekkaku	with much trouble
つい	tsui	inadvertently, carelessly
大手	oote	major company
部長	buchou	department head
前半	zenhan	first half
たまたま	tamatama	by chance, accidentally
相変わらず	aikawarazu	as usual, as before
支払い	shiharai	payment
人数	ninzuu	number of people
課長	kachou	section chief
ファッション	fasshon	fashion
体調	taichou	health condition
付き合う	tsukiau	socialize with, see (someone)
ショッピング	shoppingu	shopping
あり	ari	ant
最悪	saiaku	worst
かえる	kaeru	frog
おじさん	ojisan	Mister, middle-aged man
得	toku	advantage, gain
掴む	tsukamu	grip, grab
知り合い	shiriai	acquaintance
ペース	peesu	pace
作成	sakusei	to produce, to make
親子	oyako	parent and child
話し合い	hanashiai	talk, discussion
本社	honsha	head office of a company
打ち合わせ	uchiawase	meeting, arrangement
見守る	mimamoru	watch, keep watch over
売り上げ	uriage	sales, proceeds
かえって	kaette	rather, instead
アイドル	aidoru	idol
何となく	nantonaku	for some reason
年末	nenmatsu	end of year
無意識	muishiki	unconsciously, unintentionally
駅前	ekimae	in front of the station
やって来る	yattekuru	come all the way
キッチン	kicchin	kitchen
キス	kisu	kiss
慌てる	awateru	be flustered, be in a hurry
都内	tonai	in the metropolitan area of Tokyo
残業	zangyou	overtime work
曖昧	aimai	ambiguous, vague
カタログ	katarogu	catalogue
殴る	naguru	hit, punch
両手	ryoute	both hands
仲良く	nakayoku	harmoniously, getting along
始め	hajime	beginning, initial part
知り合う	shiriau	get acquainted with, get to know (someone)
お手伝い	otetsudai	help, assistance (polite)
マナー	manaa	manners
カラオケ	karaoke	karaoke
二度と	nidoto	never again
片手	katate	one hand
おばさん	obasan	middle-aged woman
保育園	hoikuen	day-care center, nursery school
ずれる	zureru	go off track, go out of line
ビーチ	biichi	beach
せいぜい	seizei	at most, at best
後期	kouki	latter term, second half
エアコン	eakon	air-conditioning, air conditioner
ゆったり	yuttari	comfortable, easy fit
ハードウェア	haadowea	hardware
リクエスト	rikuesuto	request
翌年	yokunen	the following year
キャンセル	kyanseru	cancellation
車内	shanai	inside a vehicle or a train
大声	oogoe	loud voice
無責任	musekinin	irresponsible
片方	katahou	one side, the other one
ボリューム	boryuumu	volume
前方	zenpou	front, ahead
日本酒	nihonshu	Japanese rice wine
青空	aozora	blue sky
不自然	fushizen	unnatural, artificial
昨晩	sakuban	last night, last evening (formal)
市役所	shiyakusho	municipal office, city hall
フルーツ	furuutsu	fruit
年々	nennen	year by year
後方	kouhou	back, rear
お詫び	owabi	apologize, apology
大根	daikon	oriental radish
むく	muku	peel (something)
例年	reinen	typical year, average year
締め切り	shimekiri	deadline
正に	masani	just, surely
蛇	hebi	snake
ラッシュ	rasshu	rush, rush hour
大げさ	oogesa	exaggerated
無理やり	muriyari	forcibly, against one’s will
外食	gaishoku	eating out, dining out
キャベツ	kyabetsu	cabbage
手足	teashi	hands and feet, limbs
閉店	heiten	shop closing
百貨店	hyakkaten	department store
クッキー	kukkii	cookie
車椅子	kurumaisu	wheelchair
大雨	ooame	heavy rain
鳩	hato	pigeon, dove
中級	chuukyuu	middle-class, intermediate
おにぎり	onigiri	rice ball
ひょっとしたら	hyottoshitara	perhaps
ぐるぐる	guruguru	round and round
和食	washoku	Japanese-style food
どく	doku	get out of the way, step aside
ウエスト	uesuto	waist
忘年会	bounenkai	year-end party
包丁	houchou	kitchen knife
ゴールデンウィーク	goorudenwiiku	golden week
シューズ	shuuzu	shoes
未成年	miseinen	minor, underage
甥	oi	nephew
葉っぱ	happa	leaf
やり直す	yarinaosu	do over again
大晦日	oomisoka	new year’s eve
サングラス	sangurasu	sunglasses
病人	byounin	sick person
顔色	kaoiro	complexion, facial expression
金色	kiniro	golden color
にらむ	niramu	glare, stare
つかまる	tsukamaru	hold on to (something)
足首	ashikubi	ankle
散らかる	chirakaru	be in a mess, lie scattered
上がる	agaru	get nervous
かぼちゃ	kabocha	pumpkin
水族館	suizokukan	aquarium
品切れ	shinagire	sold out
腫れる	hareru	swell up, be swollen
やり直し	yarinaoshi	doing over, redoing
バーゲン	baagen	bargain sale
男らしい	otokorashii	manly, masculine
近道	chikamichi	shortcut
トースト	toosuto	toast
好奇心	koukishin	curiosity
実用的	jitsuyouteki	practical
客観的	kyakkanteki	objective
抽象的	chuushouteki	abstract
送別会	soubetsukai	farewell party
敷金	shikikin	deposit, security deposit
日米	nichibei	Japan and the US
専門家	senmonka	specialist, expert
ホット	hotto	hot
わさび	wasabi	Japanese horseradish
初詣	hatsumoude	first shrine visit of the new year
ジョギング	jogingu	jogging
社会人	shakaijin	working member of society
大急ぎ	ooisogi	in a great hurry
セルフサービス	serufusaabisu	self-service
くしゃくしゃ	kushakusha	messy, crumpled
食パン	shokupan	bread in a rectangular shape
人差し指	hitosashiyubi	index finger, forefinger
洋食	youshoku	Western food
じめじめ	jimejime	damp
じろじろ	jirojiro	staringly
つるつる	tsurutsuru	smooth, slippery
こしょう	koshou	pepper
びしょびしょ	bishobisho	soaking wet, soaked
ぎゅうぎゅう	gyuugyuu	packed, crammed
バツ	batsu	cross, x-mark (on errors, mistakes etc.)
水色	mizuiro	light blue
領収書	ryoushuusho	bill of receipt (for payment only)
自然に	shizenni	naturally
とんかつ	tonkatsu	pork cutlet
ねぎ	negi	spring onion, green onion
きゅうり	kyuuri	cucumber
鰻	unagi	eel
まぐろ	maguro	tuna
パイナップル	painappuru	pineapple
ほうれん草	hourensou	spinach
マヨネーズ	mayoneezu	mayonnaise
玉ねぎ	tamanegi	onion
焼き肉	yakiniku	grilled meat, barbecued meat
目薬	megusuri	eye drops
寝過ごす	nesugosu	oversleep
国際的	kokusaiteki	international
国際化	kokusaika	internationalization
区役所	kuyakusho	ward office
和室	washitsu	Japanese-style room
本格的	honkakuteki	authentic, serious
高速道路	kousokudouro	freeway, expressway
とりあえず	toriaezu	for now, for the time being
先に	sakini	before, ahead
ぎりぎり	girigiri	just in time, barely
慌ただしい	awatadashii	busy and hurried
今ごろ	imagoro	by now, at this time
くっ付く	kuttsuku	stick, be attached
北風	kitakaze	north wind
海老	ebi	shrimp
思い切って	omoikitte	daringly, taking the plunge
はっと	hatto	taken aback, startled
宛先	atesaki	recipient’s address
ばらばら	barabara	separately, discretely
乗車券	joushaken	train ticket, bus ticket
ぶるぶる	buruburu	shivering, trembling
すらすら	surasura	smoothly, easily
終電	shuuden	last train
ずるい	zurui	cunning, sneaky
すやすや	suyasuya	(sleep) peacefully, soundly
がたがた	gatagata	with a rattling noise, unstable
非常口	hijouguchi	emergency exit
ざらざら	zarazara	rough, gritty
ぬるぬる	nurunuru	slimy
女らしい	onnarashii	womanly, feminine
急用	kyuuyou	urgent business
きょろきょろ	kyorokyoro	look around
ぐずぐず	guzuguzu	slowly, tardily
ぽかぽか	pokapoka	pleasantly warm
洗い物	araimono	dishes to be washed
かっと	katto	in a temper, in a rage
どきっと	dokitto	surprised, shocked
乗り遅れる	noriokureru	miss (a train, bus, etc.)
くたくた	kutakuta	exhausted
すべすべ	subesube	smooth, silky
にやにや	niyaniya	grin to oneself
あだ名	adana	nickname
後片付け	atokataduke	cleaning up
イカ	ika	squid
うきうき	ukiuki	excitedly
可愛がる	kawaigaru	love, cherish
餃子	gyouza	Chinese dumpling
げらげら	geragera	(laugh) out loud
ごめん	gomen	sorry
明々後日	shiasatte	three days from today
削減	sakugen	cutdown, reduction
贅沢	zeitaku	luxury, extravagance
そのうち	sonouchi	before long, sooner or later
でこぼこ	dekoboko	unevenness, bumpiness
手のひら	tenohira	palm
裸足	hadashi	bare feet
べたべた	betabeta	stick together, sticky
眉毛	mayuge	eyebrows
割り箸	waribashi	disposable chopsticks
日付け	hiduke	date (written in a document, etc.)
ぴたりと	pitarito	suddenly, coming to a dead stop
まな板	manaita	chopping board
筆記用具	hikkiyougu	pens and pencils, writing materials
くすぐる	kusuguru	tickle
かんかん	kankan	furiously angry, in a rage
白線	hakusen	white (warning) line
見覚え	mioboe	recognition, remembrance
これまで	koremade	until now, until here
からす	karasu	crow, raven
噛み付く	kamitsuku	bite
白菜	hakusai	Chinese cabbage
プロ野球	puroyakyuu	professional baseball
かみそり	kamisori	razor
何十	nanjuu	several tens
何百	nanbyaku	several hundred, hundreds
何千	nanzen	several thousand, thousands
がくんと	gakunto	sharply, significantly
飛び下りる	tobioriru	jump off, jump down
通行止め	tsuukoudome	road closed
行き止まり	ikidomari	dead end
真ん丸	manmaru	perfect circle, perfectly round
いつの間に	itsunomani	without anyone noticing
くっ付ける	kuttsukeru	attach (something), stick (something)
付け足す	tsuketasu	add on, append
得する	tokusuru	profitable, beneficial
損する	sonsuru	lose, suffer loss
言い返す	iikaesu	talk back
体温計	taionkei	(clinical) thermometer
後戻り	atomodori	turning back, retreat
話し声	hanashigoe	talking voice
くるくる	kurukuru	round and round, spin
怖がる	kowagaru	be afraid of, fear
人違い	hitochigai	mistaken identity
取り返す	torikaesu	take back, regain
乗り降り	noriori	getting on and off
口喧嘩	kuchigenka	quarrel
起き上がる	okiagaru	get up, rise
ぶら下がる	burasagaru	hang down, dangle
飛び上がる	tobiagaru	fly up, fump up
泣き声	nakigoe	tearful voice, sound of crying
持ち物	mochimono	one’s belongings
細長い	hosonagai	long and thin, long and narrow
出入り口	deiriguchi	doorway, gateway
正座	seiza	sitting on one’s heels
大喜び	ooyorokobi	great joy
落とし物	otoshimono	lost property
じゃんじゃん	janjan	many times, repeatedly
見違える	michigaeru	look completely different
合理的	gouriteki	rational, logical
自主的	jishuteki	voluntary, independent
全面的	zenmenteki	full-scale, complete
円高	endaka	strong yen
消費者	shouhisha	consumer
日中	nicchuu	Japan and China
明日	asu	tomorrow (rather formal)
結構	kekkou	all right, no thank you
辛い	tsurai	hard, painstaking
まずい	mazui	problematic, troublesome
上下	jouge	top and bottom
生	nama	raw, fresh
よける	yokeru	avoid, dodge
がやがや	gayagaya	noisily, loudly
赤ん坊	akanbou	(human) baby
ワープロ	waapuro	word processor
新聞社	shinbunsha	newspaper publisher
寝かす	nekasu	put (someone) to bed
者	mono	person (humble)
中	chuu	middle, medium size
性	sei	gender, sexual activities
会	kai	meeting, association
事	koto	thing, incident
今日	konnichi	these days
点	ten	point (of concern), dot
バック	bakku	back, reverse
記事	kiji	article, story
大	dai	big, large size
法	hou	law, rule
非常	hijou	emergency
ただ	tada	simply, merely
感じ	kanji	feeling, impression
環境	kankyou	environment, surroundings
理解	rikai	understanding, comprehension
県	ken	prefecture
使用	shiyou	use
主義	shugi	principle, -ism
国民	kokumin	citizen
下	moto	under (someone’s) supervision
場	ba	occasion, situation
労働	roudou	labor, work
機会	kikai	opportunity, chance
製品	seihin	product, manufactured goods
自身	jishin	self
かかる	kakaru	catch (a cold, etc.), come down with
求める	motomeru	seek, yearn for
下さる	kudasaru	give (honorific)
昨日	sakujitsu	yesterday (formal)
元	moto	origin, former
型	kata	type, model
それぞれ	sorezore	each, respectively
地方	chihou	local region
面	men	surface, side
実は	jitsuha	actually
夜	yoru	night, evening
地	chi	ground, place
議論	giron	discussion, debate
以前	izen	before, ago
専門	senmon	specialty, profession
申し上げる	moushiageru	tell, say (humble)
行動	koudou	action, conduct
率	ritsu	ratio, rate
監督	kantoku	supervisor, film director
意識	ishiki	consciousness, awareness
認める	mitomeru	recognize, permit
参考	sankou	reference, consultation
チーム	chiimu	team
現実	genjitsu	reality
価値	kachi	value, worth
テーマ	teema	theme, subject matter
含む	fukumu	contain, include
際	sai	opportunity, time
全て	subete	all, everything
大臣	daijin	minister
国家	kokka	state, nation
試合	shiai	match, game
結局	kekkyoku	after all, finally
消費	shouhi	consumption, spending
人生	jinsei	one’s life (to lead)
量	ryou	quantity, amount
精神	seishin	mind, mentality
レベル	reberu	level
我々	wareware	we (literary)
指導	shidou	guide, instruction
明日	myounichi	tomorrow (very formal)
資料	shiryou	materials, data
団体	dantai	group, organization
最も	mottomo	the most
完全	kanzen	perfect, complete
品	shina	goods, item
男性	dansei	male, man
軍	gun	military
描く	egaku	depict, draw
最終	saishuu	final, last (of something repeated)
センター	sentaa	center (for an activity, etc.), hub
障害	shougai	obstacle, disorder
医療	iryou	medical service, healthcare
頂く	itadaku	receive, eat (humble)
金融	kinyuu	finance
学ぶ	manabu	learn, study
成長	seichou	growth
登場	toujou	appearance (on stage, etc.)
知識	chishiki	knowledge
友人	yuujin	friend (formal)
イメージ	imeeji	image
トップ	toppu	top, the best
税	zei	tax
変更	henkou	alteration, change
限り	kagiri	limit
式	shiki	ceremony
展開	tenkai	development, storyline (plot)
興味	kyoumi	interest
含める	fukumeru	include
編集	henshuu	editing
選択	sentaku	selection, choice
無料	muryou	no charge, free
身	mi	body, oneself, one’s status
分析	bunseki	analysis
予算	yosan	budget
目標	mokuhyou	target, goal
通信	tsuushin	correspondence, communication
向ける	mukeru	turn toward, point at
時刻	jikoku	time (formal)
逆	gyaku	reverse, opposite
最高	saikou	supreme, best
利益	rieki	profit, benefit
事務	jimu	office work, business
出版	shuppan	publishing, publication
プロ	puro	professional
様々	samazama	various, diverse
州	shuu	state, province
共通	kyoutsuu	commonality
現代	gendai	present age, modern times
被害	higai	damage, harm
新た	arata	new, fresh
相当	soutou	suitability, equivalence
更新	koushin	renewal, update
得る	eru	obtain, gain
内	uchi	inside
維持	iji	maintenance, upkeep
料金	ryoukin	charge, fee (for using facilities, etc.)
到着	touchaku	arrival
なま物	namamono	uncooked food
章	shou	chapter
メンバー	menbaa	member
演奏	ensou	musical performance
案	an	plan, idea
希望	kibou	hope, wish
記憶	kioku	memory, remembrance
モデル	moderu	model
方々	katagata	people (polite)
発売	hatsubai	launch, release (of a product)
話題	wadai	topic of conversation, being talked about
目指す	mezasu	aim for
建築	kenchiku	construction, architecture
印象	inshou	impression
権利	kenri	right, privilege
学習	gakushuu	study, learning
発展	hatten	development, expansion
現場	genba	scene, job site
気分	kibun	feeling, mood
移動	idou	movement, shift
発行	hakkou	publication, issue
宗教	shuukyou	religion
改正	kaisei	revision, amendment
倍	bai	double, times
不安	fuan	uneasy, worried
自ら	mizukara	(for) oneself, personally
広告	koukoku	advertisement
共同	kyoudou	joint, cooperation
年代	nendai	generation, era
タイプ	taipu	type
差	sa	difference
営業	eigyou	business, sales
役割	yakuwari	role, duty, responsibility
改善	kaizen	improvement
撮影	satsuei	photographing, shoot
エネルギー	enerugii	energy
憲法	kenpou	constitution, constitutional law
感謝	kansha	gratitude, thanks
感覚	kankaku	sense, feel
旅	tabi	journey, travel
合わせる	awaseru	match (something), adapt (oneself)
既に	sudeni	already
現状	genjou	current condition, situation
先日	senjitsu	the other day, a few days ago
中央	chuuou	center, middle
似る	niru	resemble, be alike
平均	heikin	average
末	sue	the end, in the end
追加	tsuika	addition, supplement
なさる	nasaru	do (honorific)
様子	yousu	the state of affairs, how someone appears
活用	katsuyou	practical use, application
交換	koukan	exchange, bartering
整備	seibi	maintenance
想像	souzou	imagination
ああ	aa	like that, that much
満足	manzoku	satisfaction, contentment
以降	ikou	thereafter, later than
比較	hikaku	comparison
クラス	kurasu	class, category
犯罪	hanzai	offense, crime
おっしゃる	ossharu	say, tell (honorific)
特定	tokutei	specifying, identifying
基礎	kiso	base, foundation
流れ	nagare	flow, stream
どうも	doumo	for no special reason, somehow
村	mura	village
安定	antei	stability, composure
本人	honnin	the person himself, the said person
雰囲気	funiki	atmosphere, mood
会場	kaijou	venue, site
電子	denshi	electron, electronic
文	bun	sentence
範囲	hani	range, scope
常に	tsuneni	always, at all times (formal)
失う	ushinau	lose, miss
日常	nichijou	everyday life, daily life
回答	kaitou	reply, answer
体制	taisei	system, structure
調整	chousei	regulation, adjustment
疑問	gimon	question, doubt
応援	ouen	support, cheering
感想	kansou	thought, impression
解説	kaisetsu	explanation, commentary
シリーズ	shiriizu	series
公共	koukyou	public, community
民間	minkan	private, civilian
裁判	saiban	trial, judgment
組合	kumiai	union, guild
本来	honrai	originally, primarily
一体	ittai	what on earth
宇宙	uchuu	universe, space
申す	mousu	say, tell (humble)
図	zu	figure, diagram
クラブ	kurabu	club
観光	kankou	sightseeing
提出	teishutsu	presentation, submission (of a report, plan, etc.)
以来	irai	since then
離れる	hanareru	get away from
生	sei	life, living
性格	seikaku	character, personality
検査	kensa	inspection, examination
信頼	shinrai	reliance, trust
人物	jinbutsu	character, person
触れる	fureru	touch, come in contact with
記念	kinen	commemoration, memory
役	yaku	role, part
費用	hiyou	expense, cost
指定	shitei	designation, appointment
感情	kanjou	feeling, emotion
空	kara	emptiness, hollow
関わる	kakawaru	be involved, be concerned
仲間	nakama	comrade, peer
整理	seiri	putting something in order, sorting out
至る	itaru	come to, reach
独立	dokuritsu	independence, self-reliance
賞	shou	prize, award
誕生	tanjou	birth
いらっしゃる	irassharu	come, go (honorific)
都	to	metropolis of Tokyo
全員	zenin	all members, entire staff
明確	meikaku	clear and specific
少なくとも	sukunakutomo	at least, at a minimum
セット	setto	set
魅力	miryoku	charm, attraction
きちんと	kichinto	properly, neatly
手段	shudan	means, way
有効	yuukou	effective, valid
集中	shuuchuu	concentration, convergence
現象	genshou	phenomenon
感動	kandou	to be impressed, to be touched
禁止	kinshi	prohibition, forbiddance
会員	kaiin	member (of an association, society, etc.)
過ごす	sugosu	spend (time)
納得	nattoku	to fully understand and accept
収入	shuunyuu	income
レポート	repooto	report, paper
年齢	nenrei	age
舞台	butai	stage, setting
交通	koutsuu	traffic, transportation
他人	tanin	other people, stranger
組	kumi	school class, group, pair
否定	hitei	denial, negation
扱う	atsukau	handle, deal with
修正	shuusei	correction, revision
一応	ichiou	tentatively, just in case
生じる	shoujiru	happen, occur
訪問	houmon	visit
引用	inyou	quotation, citation
芸術	geijutsu	art, arts and crafts
解釈	kaishaku	interpretation, explanation
行	gyou	line, row
結論	ketsuron	conclusion
困難	konnan	difficulty, hardship
回復	kaifuku	recovery, recuperation
適用	tekiyou	application, coverage
集団	shuudan	group, mass
事態	jitai	situation, state of affairs
スタート	sutaato	start, begin
更に	sarani	furthermore, still more
活躍	katsuyaku	(successful) performance, action
命	inochi	life (colloquial)
医師	ishi	doctor, physician (formal)
おる	oru	be present, stay (humble)
現れる	arawareru	appear, emerge
講演	kouen	lecture, talk
瞬間	shunkan	moment
交流	kouryuu	interaction, contact
標準	hyoujun	standard, norm
まるで	marude	just like
スタイル	sutairu	style, physique
関心	kanshin	concern, interest
取り上げる	toriageru	take, confiscate
伝統	dentou	tradition
民主	minshu	democracy
制限	seigen	restriction, limit
投票	touhyou	vote, ballot
心理	shinri	mentality, psychology
大体	daitai	about, anyway
突然	totsuzen	suddenly
思想	shisou	thought, conception
応じる	oujiru	answer, comply with
不足	fusoku	lack, shortage
コード	koodo	cord
世の中	yononaka	the world, society
項目	koumoku	item, topic
旧	kyuu	old, former
次第	shidai	as soon as
長期	chouki	long period
著者	chosha	author, writer
罪	tsumi	crime, sin
楽	raku	comfortable, easy
操作	sousa	operation, manipulation
支配	shihai	control, rule
態度	taido	attitude
過程	katei	process, course
バランス	baransu	balance
連続	renzoku	continuation, series
機関	kikan	agency, facility
論	ron	argument, theory
島	tou	island