は～だ -- 
が① -- 
ね -- English tag question (such as isn’t it?; is it?; don’t you?; do you?); you know
わ② -- 
ましょう -- I/We will do something; Let’s do something.
か① -- (either) ~ or ~
か② -- Whether; if
かい -- 
かしら -- I wonder
ある① -- Be; exist; have
ある② -- Have been done; be done
いる① -- Be; exist; stay
いる② -- >Be ~ing; have done (something)
する① -- Do; make; play; play the role of ~; wear
お -- 
もう -- (not) anymore; (not) any longer; already; yet; now
まだ -- Still; (not) yet
の① -- ‘s; of; in; at; for; by; from
の② -- One
の③ -- That ~; to do something; doing something
のだ -- The explanation is that ~; The reason is that ~; The fact is that ~; It is that ~
ので -- So; since; because
を① -- 
を② -- In; on; across; through; along; over
のに① -- Even though; despite the fact that ~; although; but; in spite of the fact that ~
でも -- Even
は① -- Talking about ~; as for ~; the
も -- Too; also; (not) ~ either
どう -- How; in what way
くらい -- Approximately; about
へ -- To; towards
出す・だす -- Out; begin to; start to
で① -- At; in; on
から① -- From; since; out of
から② -- After; having done something; since (time)
と① -- And
と② -- With; as; from
て -- And; -ing
だけ -- Only; just; alone; merely; that’s all
も~も -- Both ~ and ~; neither ~ nor
し -- And what’s more; not only ~ but also ~; so
のに② -- In the process of doing ~; (in order) to do ~; for the purpose of ~
という -- Called; that says ~; that
って① -- Speaking of ~
時・とき -- At the time when; when
もの(だ) -- Because; how could ~!; used to; should like to; should
こと① -- Thing; what
つもり -- Intend to ~; be convinced that ~; believe; feel sure that ~; be going to; mean
はず -- I expect that ~; it is expected that ~; ~ is expected to; I am fairly certain that ~; should; ought to; it is natural that ~; no wonder ~
為(に)・ため(に) -- On account of ~; for the benefit of ~; for the good of ~; for the sake of ~; on behalf of ~; for the purpose of ~; in order to ~; because of ~; owing to ~
ほうがいい -- Had better do something
か(どうか) -- Whether or not; if (~ or not)
たって -- Even if ~
行く・いく① -- Go; come
下さい・ください -- Please do something
呉れる・くれる① -- Give
呉れる・くれる② -- Do something (for me or someone); do me or someone a favour by doing something
来る・くる① -- Come; visit; show up
として -- As; in the capacity of
ないで -- Do not do something and; without doing ~
なくて -- Do not do something and ~; is not ~ and ~; because ~ do not do something
ようだ -- Look like; look as if; be like; appear; seem
欲しい・ほしい① -- Want (something)
だい -- 
多い・おおい -- Many; a lot of; much
がる -- Show signs of ~
に① -- At; in; on
に② -- To; for
あとで -- After
ば -- If
たら -- If; when; after
なら -- If it is true that; if it is the case that; if; would; could
はいけない -- Cannot do something; must not do something; don’t do something; should not do something
なければならない -- Have to; must; need
な -- Don't do ~
ても -- Even if; although
てもいい -- May; It is all right if
みる -- Do something and see; try to do something
しまう -- Have dome something; finish doing something; finish something up
おく -- Do something in advance; go ahead and do something; let someone/something remain as he/it is
だろう -- Probably
かもしれない -- Might
なさい -- Do something
ことが出来る・できる -- Can; be able to
は～が -- 
あげる① -- Give
もらう① -- Get; receive; be given
そうだ① -- I hear that ~; I heard that ~; people say that ~
それで -- And; because of that; that is why; therefore; so
らしい -- Seem; look like; apparently; I heard
ように① -- So that
のは～だ -- It is ~ that ~; the one who ~ is ~; the place where ~ is ~; the reason why ~ is ~; the time when ~ is ~; what ~ is ~
さ -- -ness; -ly
が② -- But
など -- And so on; and the like; for example; things like ~
より① -- Than; rather ~ than ~; more ~ than ~
ばかり -- Only; just; be ready to do something; have just done something; just did something; be just doing something; about
お～する -- 
ことがある① -- Someone has done something; someone has had an experience doing something; there was a time when ~
要る・いる③ -- Need
お～になる -- 
ごろ -- About; around
ようと思う -- ~ think ~ will
ことになる -- It will be decided that ~; come about ~; be arranged that ~; turn out that ~
の④ -- It is that ~
それなら -- Then; in that case
少ない・すくない -- Few; a small number of; little; a small quantity of ~
を③ -- 
を④ -- 
に③ -- By; from
に④ -- On; onto
で② -- By; for; from; in; on; using; with
で③ -- And; because of; due to; because
する② -- Have
する③ -- Fear; smell; hear
間・あいだ(に) -- During (the time when); while
やはり -- Still; also; after all; as expected; you know
も② -- Even; as many/much/long/...as; (not) even (one); (not) any
そうだ② -- Look; look like; appear; seem; feel like
や -- And
で④ -- At; on; in
から③ -- So; since; because
こと② -- To ~; ~ing; that
だけで(は)なく～(も) -- Not only ~ but also ~
方・かた -- A way of; a manner of; how to
けれども -- Although; though
そして -- And; and then
知る・しる -- Get to know
それから -- After that; and then; in addition to that
ことは -- Indeed one does something alright, (but ~); indeed ~ (but ~); do ~ (but ~)
にしては -- For ~; considering that ~
行く・いく② -- Go on ~ing; continue; grow; become
に違いない・にちがいない -- There is no doubt that ~; must be ~; no doubt
それでは -- If so; then; well then
ように② -- As; like
欲しい・ほしい② -- Want (someone) to do (something)
一番・いちばん -- Most
ばよかった -- I wish ~ had done something
たらどうですか -- Why don't you do ~?; what about doing ~?
としては -- For
見える・みえる -- Be visible; (can) see; look ~
好きだ・すきだ -- Like; be fond of
する④ -- Cost; lapse
あまり -- (not) very much; (not) very
あげる② -- Do something for someone; do someone a favour by doing something
ほうが~より -- ~ be more (adjective) than ~; ~ do something more (adverb) than ~ do
ほど -- To the extent of; to the extent that ~; (not as) ~ as ~; about
まで -- As far as; till; up to; until; through; even
君・くん -- 
もらう② -- Receive benefit from an action by someone; have something done by someone; have someone do something.
難い・にくい -- Hard to ~; difficult to ~; don’t do something easily; not readily; not prone to ~
に⑤ -- To do something; in order to do something
に⑥ -- In; at; on
られる① -- Be –ed; get –ed
しか -- Nothing/nobody/no ~ but; only
とか -- And; or
ところだ① -- ~ is (in) a place where it takes ~ to get to
って② -- That
わけだ -- No wonder; so it means that ~; that's why; should ~; I take it that ~; naturally
来る・くる② -- Come about; grow; come to; begin to
代わりに・かわりに -- In place of ~; instead of; to make up for ~; although; but
自分・じぶん① -- ~ self; own
自分・じぶん② -- ~ self; own
ことがある② -- 
までに -- By; by the time (when)
前に・まえに -- Before; in front of
まま -- As it is; unchanged; undisturbed; leave as is; remain
ながら -- While; over; with
に⑦ -- To; toward.
RelativeClause -- 
たり～たりする -- Do things like ~ and ~; sometimes ~ and sometimes ~
と③ -- That; with the sound of; in the manner of
と④ -- If; when
屋・や -- Store
より② -- In ~ of; inside; outside; before; after
と言えば -- Speaking of ~
終わる・おわる -- Finish; end
様・さま -- Mr; Miss; Ms; Mrs
毎・まい -- Every; per
始める・はじめる -- Begin to
ことにする -- Decide to
なくなる -- Not ~ any more
させる -- Make someone/something do something; cause someone/something to do something; let someone/something do something; allow someone/something to do something; have someone/something do something; get someone/something to do something.
過ぎる・すぎる -- Too; do something too much/often; over-
堪らない・たまらない -- Unbearably ~; extremely; be dying to do ~
ところだ② -- Be just about to do something; be in the midst of doing something; have just done something; have been doing something; almost did something
にする -- Decide on ~; make it ~
られる② -- Be able to do something; can do something; be –able; ~ can be done
易い・やすい -- Easy to; ready to; be apt to; prone to; do something easily
ようにする -- Do ~ in such a way that ~; see to it that ~; make sure that ~; bring it about that ~
分かる・わかる -- Be comprehensible; understand; can tell; figure out
せっかく -- With effort; at great pain; take the trouble to do ~
聞こえる・きこえる -- Audible; (can) hear; it sounds
嫌いだ・きらいだ -- Don’t like; dislike
すると -- Thereupon ~; then ~; and ~
それとも -- Or; either ~ or ~
しい -- 
たい -- Want (to do something); would like (to do something)
ごとに -- Every
うちに -- While; before; during
ようになる -- Reach the point where ~; come to ~; it has come to be that ~; have finally become
ように言う -- Tell ~ to ~; say ~ in such a way
ずつ -- By; at a time.
あまり -- Because of too much ~; because ~ too much; so ~ that ~
~ば~ほど -- The more ~, the more ~
~ばかりか~(さえ) -- Not only ~ but also
べきだ -- Should; ought to
分 -- For ~; ~ worth; amount equivalent to ~; portion
だが -- But; however; yet; nevertheless
だからと言って -- However, it doesn't follow from this that ~; but it doesn't mean that ~; because of that
だけで -- Just V-ing is enough; can just ~; just by V-ing
だらけ -- Full of; filled with; covered with
で -- For; per
であろう -- Probably
である -- Be
どころか -- Far from; not just; even
どうも -- I don't know why but; I cannot manage to; just; from what I gather; seem; no matter how ~; I gather that ~; for some reason
どんなに~(こと)か -- How ~ (!)
どうせ -- In any case; anyway; at all events; after all; at all
風に -- In ~ manner; after ~ style; a la ~; like
がち -- Tend to; be prone to; be apt to; be liable to; be subject to; often
がたい -- Cannot; un—able; can hardly; difficult to; impossible
逆に -- Contrary to one's expectation; contrary to one's intention; conversely
ほど -- The ~, the ~; as; to the extent
以外 -- Other than; except (for); but; besides; as well as
以上(は) -- Since; now that; once; if ~ at all; as long as; so long as
いかにも -- Really; truly; indeed
Imperative -- (don't) V.; No -ing; (not) to V
一方で(は)~他方で(は) -- On the one hand ~, on the other hand
上 -- From the viewpoint of; for (the sake of); for (the reason); in (terms of); relating to; in –ing
かえって -- On the contrary; rather
限り -- As long as; as far as; while; to the extent; until; unless
限り② -- The last; only until; from ~ on; limited to; only
か~か -- Whether ~ or; or
かな -- I wonder if ~
必ずしも -- Not always; not necessarily
かねる -- Cannot; be not in a position to; hardly possible; hard; hesitate to do
から~に至るまで -- Starting with ~ ending with ~; from ~ to ~
から~にかけて -- Through ~ into ~; through ~ on to; from ~ till/to
からと言って -- Just because; even if; even though
かろう -- Probably
方をする -- Do something in a ~ fashion/manner/way
かと言うと -- You would think that ~ but (that is not right)
(の)代わりに -- Instead of; instead; but (to make up for ~); so (to make up for ~); in place of
結果 -- As a result of; after; upon
結構 -- Quite; rather; pretty
この -- The last; this past; this; this coming
こうした -- Such; like this
こそ -- The very ~; it is ~; that ~; only (when, after, because, etc.); in particular; precisely; definitely; [an italicized or underlined word]
こと -- (don't) V; should (not); (not) ought to; may not
ことで -- By V-ing; because; result in; cause
ことになる -- End up (with); cause; come to mean that
ことによる -- Be due to the fact that; be caused by; be brought about by; be the result of; because
ことはない -- There is no need to; not necessary; there is no possibility that; there is no chance to
く -- And; so
くらい -- To the extent that; so ~ that ~ (almost) ~; at least; the only ~; rather than ~
くせに -- Although; in spite of the fact that; and yet; but
までもない -- Not necessary (to bother) to; do not need (to go as far as) to; do not have to
まい -- Will not; will probably not; be probably not
まさか -- Incredible; never thought; never dreamed; surely not; impossible; don't tell me that ~; not at all likely; absolutely not.
ましだ -- Better; less objectionable; preferable; might as well ~
または -- Or; either ~ or ~
目 -- -th; -th one
面 -- (on) the side of; (from) the aspect of; (from) the standpoint/viewpoint of; in terms of
みせる -- Can manage to; will definitely do; am determined to
も -- Also; too; (not) either; (not) even
も~ば -- Be enough to/for; if ~ at least; if ~ as much/many as ~, it will be enough to
も~も -- Both ~ and ~; neither ~ nor ~; also; (not) either
もの(だ) -- (is) that which ~; (is) something which ~; (are) those which ~
なあ -- How ~!; what ~! ~!; I wonder; I wish
などと -- (things) like ~; ~ or something like
ながら(も) -- Although; even though; nevertheless
ないことも・はない -- It isn't the case that ~ not ~; it is not that ~ not ~
なかなか -- Quite; fairly; considerably; (not) easily; pretty; (not) readily
なく -- Not ~ and; not ~ but
何でも -- I don't know for sure, but
何しろ -- As a matter of fact; no matter what; believe it or not; you may be surprised, but ~; in fact; unbelievably
ならない -- Cannot help -ing; irresistibly; unbearably
なり~なり -- ~ or ~ (for example); like ~ or ~
なりに -- In one's own way; in one's own style
なしでは -- Without
ねばならない -- Must; have to; should
に -- 
に当たって・当たり -- On the occasion of; at; in; before; prior to
に反して・反する -- Against; contrary to; in contrast to; in violation of; while; whereas
にほかならない -- Be nothing but ~; be simply ~
に限らず -- Not limited to ~ (but also); not only ~ (but also)
に限って -- (X) of all (X's); only
に関して・関する -- Concerning; with regard to; about; on
に代わって -- In place of; replacing; on behalf of
に比べると・比べて -- Compared with/to; when compared with/to; in comparison to
にもかかわらず -- Although; though; in spite of; despite; notwithstanding; nevertheless
に基づいて・基づく -- Based upon
になると -- When it becomes; when it comes to; when; if
において・おける -- At; on; in; during
に従って・従い -- As, accordingly; in proportion to; in accordance with; following
に過ぎない -- Nothing more than; not more than; mere; merely; only; just; as little/few as; that's all
に対して・対する -- Toward; to; in contrast to; whereas; in regard to; in; per
にとって -- To; for
について -- About; on; concerning; regarding; with regard to; of
につき -- A; per; for; on; to
につれて・つれ -- As; in proportion to; with
には -- To; in order to; for; for the purpose of ~
によって・より -- According to; due to; owing to; because of; depending on; from ~ to; by means of; on the basis of; with; by
の関係で -- Because of
のこと -- About; in terms of; related to
のことだから -- Because ~ is habitually/usually/often that way; because
のみ -- Only; just; alone
の下で -- Under; in; with
の上では -- As far as ~ is concerned; as far as ~ goes; from the viewpoint/standpoint of; according to; in terms of
のは~のことだ -- It will be/was ~ when/that ~
ぬ -- Not
お~だ -- 
をはじめ(として) -- Starting with; not only ~ but also ~
お~下さい -- Please do something.
思われる -- Seem; appear; apparently
おり -- Be ~ and
を通して -- Through; by the medium of; via; throughout
っぱなし -- Keep -ing; have been -ing; leave
っぽい -- Apt to; easy to; -ish; -like
来 -- For; in; since
例の -- The ~ (in question); that (same); the usual
RelativeClause -- 
RhetoricalQuestion -- 
ろくに~ない -- Not sufficiently; not satisfactorily; not properly; not well; hardly
さ -- You know; sure; I tell you
さえ -- Even; if ~ only; if ~ just; as long as; the only thing ~ need is
際(に) -- When; on the occasion of; at the time of
さすが -- As might be expected; after all; it is only natural that ~; naturally; truly; really; indeed; impressive
せい -- Because; due to
せめて -- At least
次第 -- As soon as; depend on
しかも -- Moreover; furthermore; besides; on top of that; what's more; what's worse; more surprisingly; at that; nevertheless; and yet; even so
したがって -- Therefore; accordingly; consequently
そうかと言って -- But; yet; even so
そこで -- So; because of that; therefore
そこで② -- Then; at that time
そこを -- But; in spite of that
そうになる -- Almost
その上 -- On top of that; besides; moreover; furthermore; what's more; what's worse; not only ~ but also
それでも -- Nevertheless; yet; but in spite of that; even so
それどころか -- On the contrary; far from that; as a matter of fact
それが -- Well (contrary to your expectation; I'm afraid to say this, but)
それも -- What's more; what's worse; at that; furthermore; moreover; on top of that
それに -- (and) in addition; moreover; furthermore; what's more; on top of that
それと -- And; also; in addition; as well
それは -- (yes,) naturally; (yes,) of course; oh, surely
それぞれ -- Each; respectively
すぐ -- At once; soon; right away; immediately; readily; instantly; easily; right
たびに -- Every time; each time; on every occasion; whenever
ただ -- Only; just; simply; that's all
ただの -- Usual; ordinary; plain; common; rank and file
確かに~が -- Indeed ~ but; certainly ~ but; truly ~ but; it is true that ~ but; I admit that ~ but; definitely ~ but
たところで -- Even if
て -- And; since; having done something
て初めて -- Not until; only after; for the first time
点(で) -- Point; respect; regard; aspect; way; in terms of; -wise; in that; as far as ~ is concerned
ては -- If; when; because
と -- (thinking/saying) that ~; because; like; in such a way that ~
と同時に -- At the same time (as); at the time; when; as; while; as well as ~
と言っても -- Although ~ say/said that ~; even though ~ say/said that ~
という風に -- In such a way that; in such a fashion to suggest/show (etc.) that; as if to say/show (etc.) that
ということは -- That; the fact that
というのに -- But; although; in spite of the fact that ~
というのは~ことだ -- Mean; the meaning of ~ is; what ~ means is
と言うと -- When ~ mention; if ~ say that ~; when ~ say that ~; when it comes to
というより(は) -- Rather than; more ~ than ~
とかで -- For some reason like ~; saying something like ~; because ~ or something like that
ところ -- When; then
ところが -- However; but
とも -- No matter ~ may be; even if; at ~ -est
となる -- Become
となると -- When it comes to; if it is true that ~; if it is the case that ~; if it turns out that ~
通り(に) -- (in) the same way as; (in) the way; as
とする① -- Assume that; regard ~ as; let; suppose
とする② -- Feel ~; look ~
途端(に) -- The moment; just as; as soon as; then
とうとう -- Finally; at (long) last; eventually; in the end; after all
と共に -- As well as; with; along with; at the same time; when, as; while
とは限らない -- Not always; not necessarily
つまり -- That is (to say); namely; in short; to sum up; in other words; after all; that means
つつ -- -ing; while; although
(の)上で -- Upon ~; after ~
上(に) -- As well; in addition; besides; furthermore; moreover; not only ~ but also
得る　(うる・える) -- Can; possible; -able
Vmasu -- And; -ing
VmasuasaNoun -- 
は -- [emphatic] {do/does/did} V; will V; {am/are/is/was/were} Adjective/Noun; (not) V/Adjective/Noun
は言うまでもなく -- Not to speak of; let alone; not to mention; to say nothing of
わけだ -- As you know; the fact is that ~; the truth of the matter is that ~
わけではない -- It does not mean that ~; I don't mean that ~; it is not that ~; it is not true that ~; it is not the case that
わけがない -- There is no reason why ~; it is impossible (for ~) to ~; cannot
わけにはいかない -- Cannot; cannot but ~; cannot help -ing; have no (other) choice but to ~
やる① -- Send; give; do; play; operate; eat; drink
やる② -- (knowing that it will cause someone trouble/difficulty)
やっと -- Finally; at last; barely
よう① -- A/the way to; a/the way of -ing; the way (someone does something)
よう② -- Probably; likely; must be; should; ought; naturally
より -- More ~ (than now; than something at present; than otherwise)
ざるを得ない -- Cannot help -ing; cannot (help) but; have no choice but to ~; have to
ぞ -- I tell you; I'm telling you; you know
あえて -- Daringly; boldly; dare to ~; venture to ~; force oneself to ~
あげく(に) -- in the end; finally; eventually; after
あくまでも -- to the end; persistently; insist; strictly; just; under any circumstance; absolutely; never; completely; ultimately
あながち～ない -- (not) necessarily; (not) always
あるいは -- or; either ~ or; perhaps
あたかも -- (just) as if ~ were; (just) as if ~ did ~; just like; just; exactly
ばかりに -- Simply because; just because; simply on account of ~
ばこそ -- it is precisely because ~ that ~; only because ~; to the extent that ~
べからず・べからざる -- Shouldn’t; must not; ought not to ~; cannot; don’t ~
べく -- In order to; to; for the purpose of; for; so that ~ (can)
べくもない -- Impossible; there is no way for someone to ~; cannot be expected to
べくして -- Exactly as expected
ちなみに -- Incidentally; in this connection
だけ -- As much as; as ~ as possible; as much as one wants
だけあって -- And as one would expect; so (naturally); for good reason
だけに -- And as one would expect; so (naturally); because
だけのことはある -- Don’t do something for nothing; ~ explains it; no wonder; it’s no surprise
だに -- Just; (not) even
だの -- And (~ and); or (~ or); and things like that
だって① -- Because
だって② -- Too; also; (not) ~ either; even; any; no matter what/who/how/etc.
であれ -- Even; even if; even though; no matter what/who/how/etc.~ may be; whatever/whoever/etc.~ may be
～であれ～であれ -- Whether X or Y; be it X or Y; or
でも・じゃあるまいし -- You are not ~, so; it isn’t ~, so
～でも[Wh.word]でも -- ~ whatever; ~ whoever; ~ whenever; ~ whichever
どちらかと言うと -- Rather; more like ~; more of ~; rather on the ~ side; rather than otherwise; more ~ than ~
どうか -- Please
どころではない -- Cannot; be simply impossible; simply don’t/doesn’t have time; be far from ~; anything but ~; no way; far from; be out of question
ども -- Even though; although; though; no matter how much/often/hard/etc.
どうにも～ない -- Not ~ by any means; no matter how hard ~ try, ~ cannot ~; there is no way to ~; cannot do ~ at all
同士 -- Each other; between/among (things/people of the same kind, group, etc.); together; with
が早いか -- As soon as; the moment; no sooner ~ than
～が～なら -- If someone/something were a really good/appropriate one; if something is right
ごとし -- Like; look like
反面 -- While; on the other hand
はたして -- Just as ~ though; as expected; really; in fact; sure enough; indeed; at all; lo and behold
ひいては -- Eventually (lead to) ~; even
一[Counter]として～ない -- Not a single ~; not even one; not any ~
ひとつ -- Give something a try
一つには -- Partly; for one thing
一応 -- For the time being; for the present; for now; tentatively; for formality’s sake; nominally; kind of; sort of
如何(だ)・いかん(だ) -- How; what; (depending on) how/what; (according to) how/what; depend on
いかなる -- What kind of ~; no matter what ~; whatever; any kind of
いかに -- How; how much; how hard
いくら -- How much; how
今更・いまさら -- Too late (for/to ~); now
一方(だ) -- Only; always; continue to; keep ~ing; be steadily ~ing; become ~er and ~er
一方(で) -- While; when; (but) at the same time; on the other hand; even though; although
以来 -- Since
一切～ない -- Not ~ at all; absolutely not; not ~ whatsoever
一旦・いったん -- Once; for a time; temporarily; for the moment; for the present; now
言ってみれば -- Figuratively speaking; so to speak; metaphorically speaking; in a manner of saying
言うまでもない -- It is needless to say that ~; needless to say; it goes without saying
言わば -- So to speak; as it were; like; sort of
いわゆる -- So-called; what we call; known as
自体 -- Oneself; in and of itself; the very
限りだ -- extremely
甲斐・かい・がい -- Worth; meaning; effect; result
か否か -- Whether X or not
かな -- How ~ !; what a(n) ~ !; to my/our ~; it is ~ that
かのように -- As if
から言って -- In terms of; from the viewpoint of; judging from
からなる -- Consist of; be composed of
からには -- Once; now that ~; as long as ~; so long as ~; if
からして -- Even; judging from
仮に -- Supposing that; suppose; providing that; (even) if
かと思うと -- As soon as (one notices that) ~; soon after; when one thinks/feels that ~
且つ・かつ -- And; and also; yet; but; and ~ as well; as well as; moreover
きらいがある -- Have a tendency to; tend to; have a touch of ~; have a dash of ~; smack of ~; be slightly ~
(っ)きり -- Since; only
っけ -- 
この上ない -- Extremely; utterly; very; so; cannot be more; extreme; utmost
ことか -- How ~!; what a(n) ~!
ことから -- Because; due to; from the fact that ~; cause; trigger
ことに -- It is ~ that; I am ~ that; we are ~ that; to my/our ~; ~ly
加えて -- In addition; and additionally; what’s more
まで(のこと)だ -- Just; merely; only
まして(や) -- To say nothing of; not to speak of; let alone; still more; much less; all the more reason why
また -- Again; also; too; (not) ~ either; and; additionally; or
滅多に～ない -- Rarely; seldom; hardly; almost never
見るからに -- Visibly; obviously; really look; can be easily recognised as; can tell just by looking at ~
～も[V]ば～も[V] -- There are times when ~ and/or ~; sometimes ~ and sometimes ~; sometimes do things like ~ and ~; some (people/etc.) ~ and some (people/etc.) ~
ものではない -- Shouldn’t; not possibly; naturally cannot; cannot bear
ものか① -- Definitely not; absolutely not; impossible
ものか② -- Wish; wonder if; should
ものなら -- If; if ~ at all
ものの -- Although; though; even though; but
ものを -- Although; but
もさることながら -- ~ is one thing, but; it is true that ~, but; it is the case that ~, but; but more importantly
もしくは -- or
もっとも -- Although; though; but; yet; however
向け -- For; made for; for the use of; aimed at; directed towards; (directed/shipped/etc.) to
むしろ -- Rather; instead
ないでもない -- Seem to ~; somewhat; rather; may
ないことには -- If ~ not ~ then; unless
ないまでも -- May not ~ but; even though ~ not; although ~ not
ないし(は) -- From ~ to ~; between ~ and ~; or
中を -- In the midst of; when; while; through; among
なくして(は) -- Without; if it were not for ~
なまじ(っか) -- Halfheartedly; slightly; thoughtlessly; unwisely; inadequately; imperfectly; sort of; a little; somewhat; a bit of
並み -- About the same level as; like; as (much ~) as; to match; to rival; on a par with; equivalent to
何[(Number)+Counter]も -- Many; tens/thousands/etc. of ~
何～ない -- Doesn’t exist at all; without
何も～ない -- Why ~ have to ~?; it is unnecessary to ~; have no good reason to ~; not need to ~
何らかの -- Some; some kind of
何ら～ない -- Not ~ at all; not any ~; nothing; no ~ whatsoever
なんて① -- What; how ~!; what a(n) ~!; so
なんて② -- That; things like
何とか -- Somehow; in some way; in one way or another; manage to
なお -- Still; even more; all the more for ~; additional; and; additionally; furthermore
なおさら -- Still more; much more; all the more; even more
ならでは(の) -- Impossible if it’s not ~; only possible with/by/at/etc.; not possible with/by/at/etc. other ~; very difficult with/by/at/etc. any other ~ but; you can expect only/at/from/etc.; unless
並びに -- And; both ~ and ~; as well as
なり -- The moment; when; as soon as; soon after; no sooner ~ than
なるほど -- Indeed; it is true ~ (but); really; I see
なしに -- Without
なす -- Do; perform; make; change; constitute
なぜか -- I don’t know why; without knowing why; for an unknown reason
なぜなら(ば)～からだ -- The reason is that ~; because
んばかり(に) -- As if ~ were about to ~; almost
願う・願います -- Please; ask (for)
にひきかえ -- In contrast to ~; while; whereas
にいたっては -- When it comes to ~; as for; for example
にかかわらず・に関・拘・係わらず -- Regardless of; independent of; without reference to; without distinguishing; whether X or Y; whether X or not; whatever/whoever/etc.
にかけては -- When it comes to ~; as for; in point of; in terms of; about; regarding
にかたくない・に難くない -- Not hard; easy ~
に決まっている -- Surely; be bound to; be a given; of course; must be; we all know that
に越したことはない -- Nothing is better than; if possible; be the best; be ideal; the ~ the ~
に・ともなると -- When; if; as
に向けて・に向けた -- Toward; to; at; aiming at; targeting; for; for the purpose of; in order to
～に～ない -- Cannot manage to; just cannot; cannot ~ even though ~ want to; cannot ~ despite the fact that ~ want to
に(も)なく -- Unusually; more ~ than usual
に応じて・応じた -- In response to; according to; depending on; appropriate for; suitable for; suited to; meet
にしろ・せよ -- Even though (it is/was the case that); even if (it is true that); although (it is/was the case that); whatever/whoever/etc.; no matter what/who/how/etc.; whether X or Y
にしたところで -- Also; (even) for ~
にして① -- In; at; over; while
にして② -- And; both ~ and ~
にしてからが -- even
にしても -- Even if (someone decides to/it is true that); although/even though (it is true that/it is the case that/we admit that/we agree that/etc.); whatever/whoever/etc.; no matter what/who/how/etc.; whether X or Y; as for ~, too; even (so)
にとどまらず -- Doesn’t stop with ~; doesn’t end with ~; not limited to ~; going beyond ~; not only ~ (but also ~)
につけ -- As; every time; whenever
にわたって・わたる -- For; over; extending; stretching; ranging; covering
によらず -- Without; without ~ing; regardless of; independently of; without reference to; whether X or Y; whether X or not; whatever/whoever/etc.; no matter what/who/how/etc.
によると -- According to; based on
のみならず -- Not only ~ (but also ~); not only that
のなんのって -- So (~ that); so much/well (~ that); so ~ and
の無さ・のなさ -- Lack of; absence of
～の～のと -- Saying ~, ~, and so on; saying ~ or ~
んとする -- Try to do; be about to
を中心に -- Centering around; around; focusing on; mainly; primarily; with ~ as the center; with ~ as the leader; with ~ as the primary ~; take the lead
を介して・介した -- Through; via; by means of; by ~ing
を禁じ得ない -- Cannot hold; cannot hold back; cannot keep back; cannot help ~ing; cannot keep ~ from ~ing
をめぐって・めぐる -- Centering around; in connection with; over; concerning; regarding; with regard to
思えば -- Come ot think of it; when I think back; on reflection
をものともせず -- In spite of ~; undaunted by ~; in definance of ~; in the face of ~
思うに -- In my view; it seems to me that ~; when I think (about ~); considering
をおいてほかに(は)～ない -- (there is) no ~ but X; X is the only one; nothing else is ~ but X; no other ~ are/do something as ~ as X
折(に) -- On the occasion; at the time; when; if; opportunity; chance
恐れがある -- It is feared (that); we fear (that); we are worried/concerned (that); there is a fear/risk/chance/concern/etc.; can; could; may; it is possible (that); be in danger of
を問わず -- Regardless of; irrespective of; without reference to; whether X or Y; whether X or not; whatever/whoever/etc.; no matter what/who/how/etc.
及び -- And
およそ -- Generally; commonly; all; quite entirely; totally; utterly; (not) at all; for the most part; mostly; almost; approximately; roughly; about; rough; general
をよそに -- Indifferent to ~; contrary to ~; ignoring ~; despite
さも -- Truly; really; as if; so; that way; like that
更に -- Even ~er; even more; additional; more; further; furthermore; in addition
さて -- Well; now; well now; so
さぞ(かし) -- I believe/I’m sure/I’m certain ~ very/really/truly ~; must be very/really/truly ~
そもそも(の) -- In the first place; to begin with; first of all; the very (beginning/origin/etc.); original; first; fundamental
そのもの -- Itself; themselves; very; perfect; the definition of; the picture of; absolutely; totally; utterly; perfectly
それだけ -- That much; to the same extent; to the same degree; equally
それなりに・の -- In one’s own way; accompanying; proportionate; suitable; expected; agreeable; reasonable; one’s own; proper to
末(に) -- After; at the end of
済む -- Take/cost/need/etc. only ~; do/manage (without/only with); get by/get away (without/only with); be let off (without/only with); be enough (if); be all right (if); not to have to: there is no need for
ただ -- But; however; only; the only thing is that ~
但し・ただし -- However; but; only; here; provided that
たかが -- Only; just; mere
たなり(で) -- Without; while ~ staying; while ~ keep ~ing
単位で -- By the; in sets/groups/lots/etc. of; in multiples of; each; every
単に -- Just; only; simply; no more than; nothing but; solely; merely; alone
たるや -- When it comes to ~; speaking of
(っ)たって① -- Even if; if; whether; no matter what/who/how/etc.
(っ)たって② -- Even if (someone says that); even if someone tries to; although
てばかりはいられない -- Cannot just; cannot always; cannot just keep ~ing; cannot spend time just ~ing; cannot waste time just ~ing
～ても～ても -- No matter how much/often/hard/etc.; no matter how many times
て仕方がない -- Cannot help ~ing; cannot stop feeling; (so ~ and) cannot control ~; so ~ and ~ cannot bare it; so; unbearably
てはいられない -- Cannot/shouldn’t be ~ing; cannot/shouldn’t keep ~ing; cannot/shouldn’t (stay/remain/etc.); cannot/shouldn’t waste time ~ing; cannot afford to; cannot help ~ing
とあって -- Because ~, ~ as expected; because ~, naturally ~; because
とあっては -- If it is true that; if it is the case that; if; because; since
とばかりに -- As if; as if to say that; as if ~ were convinced that; as if ~ believed that; as if ~ decided that
とでも言うべき -- Which could/may be called; which can/could be described as
といえども -- Even; any; although; though; even though
～といい～といい -- In terms of both ~ and ~; in terms of ~ as well as ~; from the perspective of both ~ and ~
といった -- Like; such as; among others
といったところだ -- I would say ~; ~ is how I’d put it
と言って -- However; but; having said that
と言うか -- Or; or rather; or I’d (rather) call it; or I may call it; or I’d (rather) say; or I may say
と言うのは -- (I’m saying this) because; the reason (why I’m saying this) is that; by ~ I mean that; what I mean is that
~言わず~と言わず -- A, B and many other ~; A, B and every ~ else; including: whether X or Y
ところから -- Because; be caused by the fact that ~; from the fact that ~
ともなく -- Without intending to; without paying much attention; unconsciously; mindlessly; don’t know (exactly) who/where/etc. (but); cannot tell (exactly) who/where/etc. (but); (to/from) no particular (person, etc.)
ともすると -- Tend to; apt to; be likely to; easily; be bound to
との -- That
とても～ない -- Cannot possibly; totally impossible; there is no possibility; there is no way; not ~ at all; not ~ by any means; by no means
とは -- (not think/expect/etc.) that; (be surprised/be glad/regret/etc.) that
とは言え -- Although (it is said that/someone says that); even though (it is said that/someone says that); admitting that; that being said; however; nevertheless
つい -- Unintentionally; without being able to control onself; without meaning to; carelessly; involuntarily; in spite of oneself; just; only
ついでに -- When; while (~ at it); as; on one’s way to; since ~ (anyway); as well; at one’s convenience
ついては -- Therefore; thus; so; because of this; for this reason; with regard to this
(と言)ったらない -- So; extremely; indescribably; indescribable; incredibly; awfully; terribly; cannot tell you/describe/etc. how; too much of
はあれ -- Even though there is; although there is; there is ~ but
は別として -- Except for; putting/setting aside; whether X or Y
はいいとしても -- Be all right, but; might be all right, but; would be fine, but; would accept ~, but; even if ~ accept; even though ~ accept; although ~ accept
はおろか -- Let alone; not only ~ (but also ~); not to mention; to say nothing of; never mind; much less
割に(は) -- For; despite; although; (not) as much as; (not) ~ because of that; considering
～わ～わ -- X and Y; for example, X and Y; because X and Y; so many; so much; one after another
や否や・やいなや -- As soon as; no sooner ~ than; the moment; soon after; immediately after
やら -- I wonder (if)
～やら～やら -- X and Y; things like X and Y; X, Y and so on; whether X or Y; whether X or not
ようでは -- If; if it is true that; if it is the case that
ようものなら -- If ~ happen to; if ~ at all; if ~ choose to
ようにも(～ない) -- Even though ~ try/want to ~; even though ~ be thinking of doing ~; although ~ try/want to ~; although ~ be thinking of doing ~
より・のほか(に)(は)～ない -- There is no (other) choice but to; there is no other way than to; have to; nothing but; but; not ~ other than
由・よし -- (I heard/It is said/etc.) that
ようと・が -- Even if; whatever/whoever/ etc.; no matter what/who/how/etc.; whether X or Y
故に・ゆえに -- Because; because of; due to; therefore
ずにはおかない -- Be bound to; definitely; unmistakably; unquestionably; undoubtedly; without fail; without doubt
ずして -- Without ~ing; before (~ing); with no ~; if ~ do not; when ~ do not
ずとも -- Without ~ing; even if ~ not; if ~ not
